"","ref_musee","telephone1","sitweb","region","departement","osm_id","name","number","street","postal_code","city","country","country_code","status","lat","lon","payant.2018","gratuit.2018","total.2018","payant.2017","gratuit.2017","total.2017","payant.2016","gratuit.2016","total.2016","payant.2015","gratuit.2015","total.2015","payant.2014","gratuit.2014","total.2014","payant.2013","gratuit.2013","total.2013"
"1","0126901","0474750750","www.musees.ain.fr","AUVERGNE-RHÔNE-ALPES","AIN",138473284,"Musée de la Résistance et de la Déportation de l'Ain","3","Montée de l'Abbaye","01130","Nantua","France","fr","open",46.1525,5.60827747048556,7851,5096,12947,1764,2433,4197,786,244,1030,3893,1979,5872,7149,4270,11419,7206,3373,10579
"2","1458201","0231310003","www.lintercom.fr","NORMANDIE","CALVADOS",329998597,"Château de Saint-Germain de Livet",NA,"D 268","14100","Saint-Germain-de-Livet","France","fr","open",49.0890928,0.214375676022239,9104,6868,15972,8835,7193,16028,8638,7968,16606,10387,7880,18267,10572,6559,17131,9535,8421,17956
"3","7662401","0235045398","www.musee-horlogerie-aliermont.fr","NORMANDIE","SEINE-MARITIME",1826563,"Association de l'Horlogerie Aliermontaise",NA,NA,"76510","Saint-Nicolas-d'Aliermont","France","fr","open",49.878403,1.2140639,3532,1309,4841,3666,1323,4989,2807,3472,6279,4048,2516,6564,4955,2524,7479,5081,2382,7463
"4","3155509","0567738484","www.museum.toulouse.fr","OCCITANIE","HAUTE-GARONNE",134123637,"Muséum d'Histoire Naturelle",NA,"Allée des Justes des Nations","31400","Toulouse","France","fr","open",43.59334975,1.44953003599785,168455,137341,305796,164336,125526,289862,137034,130549,267583,139251,134681,273932,144037,150530,294567,124863,118569,243432
"5","6604902","0468873192","www.musee-ceret.com","OCCITANIE","PYRENEES ORIENTALES",2004488993,"Musée départemental d'Art Moderne",NA,"Boulevard du Maréchal Joffre","66400","Céret","France","fr","open",42.4859058,2.7484863,48306,6900,55206,56167,23686,79853,50591,21301,71892,43020,28680,71700,47304,16148,63452,52179,25814,77993
"6","5300301","0243049619","Site de la ville","PAYS DE LA LOIRE","MAYENNE",277287315,"Musée des Tisserands Mayennais",NA,"Place Billard de Veaux","53300","Ambrières-les-Vallées","France","fr","open",48.403429,-0.630839047872341,136,171,307,202,113,315,229,122,351,211,14,225,312,40,352,369,43,412
"7","1300101","0442918875","www.aixenprovence.fr/Pavillon-de-Vendome-465","PROVENCE-ALPES-CÔTE D'AZUR","BOUCHES DU RHONE",34505703,"Musée du Pavillon de Vendôme",NA,"Rue Cardinale","13626","Aix-en-Provence","France","fr","open",43.5254678,5.4526102,6742,14364,21106,5488,16006,21494,4435,15085,19520,5274,11739,17013,4850,10312,15162,5158,11392,16550
"8","0608808","0493627240","http://www.nice.fr/fr/culture/musees-et-galerie/palais-lascaris-le-palais","PROVENCE-ALPES-CÔTE D'AZUR","ALPES-MARITIMES",578023554,"Musée du Palais Lascaris","15","Rue Droite","06300","Nice","France","fr","open",43.6974774,7.2772468,20078,32797,52875,24565,15729,40294,15825,15399,31224,17295,11947,29242,0,93178,93178,21295,81225,102520
"9","8313704","0494020201","www.musee-marine.fr/toulon","PROVENCE-ALPES-CÔTE D'AZUR","VAR",842473302,"Musée National de la Marine de Toulon",NA,"Sortie de l'Arsenal","83800","Toulon","France","fr","open",43.12182215,5.92835498379377,26463,30346,56809,30710,24762,55472,23389,34748,58137,21446,36443,57889,21853,35086,56939,25513,39777,65290
"10","8313701","0483954420","www.museum-toulonvar.fr","PROVENCE-ALPES-CÔTE D'AZUR","VAR",145358669,"Muséum d'Histoire Naturelle de Toulon et du Var","737","Chemin du Jonquet","83200","Toulon","France","fr","open",43.1433259,5.91079729714489,0,39299,39299,0,49705,49705,0,43400,43400,0,43744,43744,0,67108,67108,0,77454,77454
"11","0216801","0323690560","www.musee-jean-de-la-fontaine.fr","HAUTS-DE-France","AISNE",5425520722,"Musée Jean de la Fontaine",NA,"Rue Jean De La Fontaine","02400","Château-Thierry","France","fr","open",49.0467222,3.4001157,8088,1509,9597,10557,3292,13849,12038,3040,15078,10481,2353,12834,11956,2216,14172,11841,2145,13986
"12","6811201","0389742289","www.ville-guebwiller.fr/musee-deck/","GRAND EST","HAUT-RHIN",70325197,"Musée Théodore Deck et des Pays du Florival","1","Rue du 4 Février","68500","Guebwiller","France","fr","open",47.90581675,7.21537129481707,1442,3649,5091,1906,4590,6496,791,5094,5885,1534,3961,5495,1206,5122,6328,1335,4594,5929
"13","7510706","0140628425","www.legiondhonneur.fr","ÎLE-DE-France","PARIS",895871273,"Musée National de la Légion d'Honneur et des Ordres de Chevalerie",NA,"Rue de la Légion d'Honneur","75007","Paris","France","fr","open",48.8602845,2.3247488,0,50240,50240,0,50436,50436,0,48651,48651,0,50111,50111,0,58195,58195,0,49531,49531
"14","3155503","0531229540","Site des musées de la région : www.musees-midi-pyrenees.fr/","OCCITANIE","HAUTE-GARONNE",833971998,"Musée Paul Dupuy",NA,"Rue de la Pleau","31000","Toulouse","France","fr","open",43.5969961,1.44691766083441,3842,15216,19058,9439,17343,26782,6680,13268,19948,6490,7695,14185,5031,8326,13357,5547,7923,13470
"15","0608806","0497134680","www.mhnnice.org ou www.nice-coteazur.org","PROVENCE-ALPES-CÔTE D'AZUR","ALPES-MARITIMES",1398474011,"Muséum d'Histoire Naturelle","60","Boulevard Risso","06300","Nice","France","fr","open",43.7019475,7.2797089,1353,1100,2453,1522,4027,5549,1426,2895,4321,1642,3332,4974,0,29527,29527,0,33271,33271
"16","2828001","0237521802","www.ville-nogent-le-rotrou.fr/html/art_cult/musee/collec.htm","CENTRE-VAL DE LOIRE","EURE ET LOIR",6528325404,"Musée de l'Histoire du Perche",NA,"Rue des Marches du Saint-Jean","28400","Nogent-le-Rotrou","France","fr","open",48.3143308,0.820474,5738,7092,12830,5803,7577,13380,9202,10818,20020,7957,11289,19246,9234,11429,20663,8744,6471,15215
"17","6753801","0388890814","www.musee-lalique.com","GRAND EST","BAS-RHIN",1773559189,"Musée Lalique",NA,"Rue du Hochberg","67290","Wingen-sur-Moder","France","fr","open",48.9265922,7.3620686,36413,12153,48566,35706,11568,47274,40198,12378,52576,37986,11324,49310,41478,10448,51926,48870,9955,58825
"18","2432203","0553530092","/www.perigueux-vesunna.fr/","NOUVELLE-AQUITAINE","DORDOGNE",75346425,"Musée Gallo-Romain de Vesunna",NA,"Rue 26e Régiment d'Infanterie","24000","Périgueux","France","fr","open",45.1794786,0.713209632058521,22195,11458,33653,22576,14487,37063,20718,13676,34394,20967,15964,36931,17275,13360,30635,18686,16622,35308
"19","0608811","0493538720","www.musees-nationaux-alpesmaritimes.fr","PROVENCE-ALPES-CÔTE D'AZUR","ALPES-MARITIMES",140067117,"Musée National Marc Chagall","36","Avenue du Docteur Ménard","06000","Nice","France","fr","open",43.709136,7.26952704651163,108132,64757,172889,98185,54361,152546,92397,52906,145303,86745,45008,131753,106900,52054,158954,112414,53526,165940
"20","6137901","0233734806","www.ecomuseeduperche.fr","NORMANDIE","ORNE",4317391883,"Musée Départemental des Arts et Traditions Populaires du Perche",NA,"D 277","61130","Saint-Cyr-la-Rosière","France","fr","open",48.3249849,0.6549988,10492,10129,20621,12071,11814,23885,10068,12013,22081,10789,11693,22482,11765,11540,23305,10182,11818,22000
"21","3035001","0467810686","www.musee-cevenol-levigan.fr ou http://museecevenol-levigan.jimdo.com/","OCCITANIE","GARD",2363137316,"Musée Cévenol","1","Rue des Calquières","30120","Le Vigan","France","fr","open",43.9889631,3.6072627,1383,1994,3377,1856,1855,3711,1491,1721,3212,1580,1932,3512,2069,1464,3533,1840,2782,4622
"22","1104901","0468789119","www.eburomagus.com","OCCITANIE","AUDE",1722803126,"Eburomagus Musée Archéologique","2","Avenue du Razès","11150","Bram","France","fr","open",43.2438113,2.1161341,815,2007,2822,648,2272,2920,866,2504,3370,931,1245,2176,985,1213,2198,1747,1366,3113
"23","0921101","0561010694","Site de la ville : www.citaenet.com/montsegur","OCCITANIE","ARIEGE",1751723922,"Musée d'Archéologie",NA,"D 409","09300","Montségur","France","fr","open",42.8716796,1.8332911,15029,0,15029,15604,0,15604,1397,13791,15188,1666,14716,16382,0,18518,18518,0,17599,17599
"24","4028701","0558780233","www.ville-sanguinet.fr","NOUVELLE-AQUITAINE","LANDES",26246232,"Musée Municipal du Lac",NA,"Allée du Musée","40460","Sanguinet","France","fr","open",44.4825995,-1.0754788,2035,1314,3349,2275,1327,3602,1962,1109,3071,2545,790,3335,1719,1349,3068,1281,330,1611
"25","4214701","0477963915","Site de la ville www.ville-montbrisson.fr","AUVERGNE-RHÔNE-ALPES","LOIRE",163997717,"Musée d'Allard",NA,"Avenue d'Allard","42600","Montbrison","France","fr","open",45.6082165,4.06163371956912,2869,6747,9616,1720,9839,11559,1324,5838,7162,1145,8509,9654,1811,10994,12805,1926,9011,10937
"26","6706101","0388003839","www.museedupaysdehanau.eu","GRAND EST","BAS-RHIN",2399054638,"Musée du Pays de Hanau - Histoire et Vies d’un Territoire",NA,"Rue du Canal","67330","Bouxwiller","France","fr","open",48.8249535,7.4835103,1803,5646,7449,1816,3973,5789,2124,4065,6189,3062,1246,4308,4940,0,4940,5106,0,5106
"27","8509201","0251534004","www.ville-fontenaylecomte.fr","PAYS DE LA LOIRE","VENDEE",252173072,"Musée de Fontenay-le-Comte",NA,"Rampe du Musée","85240","Faymoreau","France","fr","open",46.5560261,-0.6289655,1081,2733,3814,1830,1557,3387,2400,2526,4926,2162,3326,5488,2124,3383,5507,2497,3085,5582
"28","7127501","0385253705","www.tour-du-moulin.fr","BOURGOGNE-FRANCHE-COMTE","SAONE ET LOIRE",2690539792,"Musée de la Tour du Moulin","9","Rue de la Tour du Moulin","71110","Marcigny","France","fr","open",46.274612,4.0431847,1314,777,2091,1290,612,1902,1170,731,1901,1096,603,1699,1433,520,1953,1096,327,1423
"29","6822405","0389428333","www.citedutrain.com","GRAND EST","HAUT-RHIN",4551159534,"Cité du Train",NA,"Rue Alfred de Glehn","68200","Mulhouse","France","fr","open",47.7500026,7.2938678,64954,35363,100317,67957,20190,88147,64390,18062,82452,66480,27123,93603,62268,28804,91072,78346,9125,87471
"30","3818508","0476423853","www.resistance-en-isere.fr","AUVERGNE-RHÔNE-ALPES","ISERE",35081222,"Musée de la Résistance de la Déportation de l'Isère",NA,"Rue Hébert","38000","Grenoble","France","fr","open",45.19011945,5.73520277503324,0,36163,36163,0,27661,27661,0,31146,31146,0,25116,25116,0,28217,28217,0,28749,28749
"31","9111401","0160463360","www.brunoy.fr","ÎLE-DE-France","ESSONNE",48359053,"Musée Municipal Robert Dubois-Corneau",NA,"Rue de la Glacière","91800","Brunoy","France","fr","open",48.7003494,2.50073160632797,139,2555,2694,39,3749,3788,65,4059,4124,67,2804,2871,67,3237,3304,69,3132,3201
"32","5935004","0328368400","www.mairie-lille.fr ou http://www.pba-lille.fr/spip.php?article167","HAUTS-DE-France","NORD",7818582178,"Musée de l'Hospice Comtesse",NA,"Rue de la Monnaie","59021","Lille","France","fr","open",50.6411688,3.0632054,21140,34654,55794,33100,18110,51210,30806,20588,51394,55390,0,55390,29556,22200,51756,89900,0,89900
"33","9106401","0169351650","www.museedelaphoto.fr","ÎLE-DE-France","ESSONNE",7035962879,"Musée Français de la Photographie",NA,"Rue de Paris","91570","Bièvres","France","fr","open",48.762826,2.225102,3849,2758,6607,3462,2432,5894,1932,2052,3984,1644,6970,8614,2446,6128,8574,1579,36712,38291
"34","1320402","0491145950","www.museum-marseille.org","PROVENCE-ALPES-CÔTE D'AZUR","BOUCHES DU RHONE",68977335,"Muséum d'Histoire Naturelle",NA,"Impasse Montbard","13004","Marseille","France","fr","open",43.30378565,5.39459463967337,15666,58934,74600,14179,53339,67518,14276,55173,69449,13241,52136,65377,21177,82366,103543,8425,36247,44672
"35","0615502","0493647183","http://musees-nationaux-alpesmaritimes.fr/picasso/","PROVENCE-ALPES-CÔTE D'AZUR","ALPES-MARITIMES",88040667,"Musée Picasso la guerre et la paix à Vallauris",NA,"Place de la Libération","06220","Vallauris","France","fr","open",43.580016,7.0532145,17910,8502,26412,13516,6714,20230,21355,8732,30087,19260,8531,27791,17921,16255,34176,16910,14098,31008
"36","0601801","0492915030","www.musee-fernandleger.fr ou http://musees-nationaux-alpesmaritimes.fr/fleger/","PROVENCE-ALPES-CÔTE D'AZUR","ALPES-MARITIMES",1416739719,"Musée Fernand Léger",NA,"Chemin du Val de Pome","06410","Biot","France","fr","open",43.6212652,7.1123586,14892,17953,32845,13267,15427,28694,13238,15244,28482,12799,13336,26135,14851,13744,28595,14644,13920,28564
"37","2505604","0381878316","www.citadelle.com","BOURGOGNE-FRANCHE-COMTE","DOUBS",7345774098,"Musée Comtois",NA,"Chemin de Ronde de la Citadelle","25000","Besançon","France","fr","open",47.2298091,6.034391,34270,0,34270,13467,19352,32819,0,0,0,50272,0,50272,0,0,0,0,0,0
"38","3856201","0476680735","www.musee-revolution-francaise.fr","AUVERGNE-RHÔNE-ALPES","ISERE",1249592087,"Musée Départemental de la Révolution Française",NA,"Parvis du Château","38220","Vizille","France","fr","open",45.0757435,5.7735647,0,69610,69610,4671,65331,70002,4748,53268,58016,4152,60923,65075,4143,58640,62783,4364,56352,60716
"39","6800401","0389400194",NA,"GRAND EST","HAUT-RHIN",5144762817,"Musée Sundgauvien d'Altkirch","38","Rue de Luppach","68480","Vieux-Ferrette","France","fr","open",47.5040397,7.3041592,382,4962,5344,854,1542,2396,562,1615,2177,625,3151,3776,546,3420,3966,1030,2168,3198
"40","5960601","0327225720","www.valenciennes.fr(culture/musee)","HAUTS-DE-France","NORD",626582331,"Musée des Beaux-Arts",NA,"Rue des Incas","59300","Valenciennes","France","fr","open",50.3575723,3.5306353,65635,22885,88520,23323,11894,35217,25149,15284,40433,7745,12318,20063,31504,0,31504,38880,0,38880
"41","7654009","0235712882","Site des musées de la région ou www.rouen.fr/corneille ou www.rouen-histoire.com/Corneille/","NORMANDIE","SEINE-MARITIME",8063434964,"Musée-Maison Natale Pierre Corneille",NA,"Rue de la Pie","76000","Rouen","France","fr","open",49.4430989,1.0867988,0,7699,7699,0,5953,5953,0,5730,5730,0,7092,7092,0,3911,3911,0,5717,5717
"42","3417203","0467148300","www.museefabre.montpellier3m.fr","OCCITANIE","HERAULT",1226892,"Musée Fabre",NA,"Cour de la Mosaïque","34062","Montpellier","France","fr","open",43.6117542,3.88012743260019,226223,68054,294277,225213,27828,253041,210596,88625,299221,111200,80524,191724,124382,92437,216819,195794,86275,282069
"43","1305507","0491145880","Site de la ville","PROVENCE-ALPES-CÔTE D'AZUR","BOUCHES DU RHONE",4945719803,"Musée d'Archéologie Méditerranéenne",NA,"Rue de la Vieille Tour","13000","Marseille","France","fr","open",43.3005836,5.3682814,78748,118240,196988,40401,60031,100432,36294,18578,54872,52124,62920,115044,71251,43880,115131,55467,60114,115581
"44","1320101","0491622182","www.marseille.fr","PROVENCE-ALPES-CÔTE D'AZUR","BOUCHES DU RHONE",67708610,"Musée Grobet-Labadié",NA,"Place Henri Dunant","13001","Marseille","France","fr","open",43.30331955,5.39297786857565,0,3313,3313,0,1485,1485,0,1917,1917,0,7434,7434,0,2943,2943,16683,0,16683
"45","5806202","0386851855","www.cg58.fr/patrimoi/costu.htm","BOURGOGNE-FRANCHE-COMTE","NIÈVRE",3618004518,"Musée du Costume",NA,"Place du Château","58120","Château-Chinon (Ville)","France","fr","open",47.0672537,3.9351818,2684,894,3578,2848,892,3740,2934,1021,3955,3009,1131,4140,3483,1359,4842,3881,1527,5408
"46","7101404","0385520915","www.autun.com/tourisme/museum.php","BOURGOGNE-FRANCHE-COMTE","SAONE ET LOIRE",223582725,"Museum d'Histoire Naturelle Jacques de La Comble",NA,"Allée Jacques de la Comble","71400","Autun","France","fr","open",46.9499423,4.3172422,556,2384,2940,533,2270,2803,507,2584,3091,1244,2275,3519,1453,2137,3590,1008,1929,2937
"47","7301101","0479378686","www.albertville.fr","AUVERGNE-RHÔNE-ALPES","SAVOIE",152123714,"Musée Municipal d'Albertville-Conflans",NA,"Place de Conflans","73200","Albertville","France","fr","open",45.670647,6.39710073809524,3326,2289,5615,2928,2575,5503,4065,1889,5954,2952,2170,5122,3053,3370,6423,2317,2275,4592
"48","5730601","0382857655","www.musee.desminesdefer-lorraine.com","GRAND EST","MOSELLE",743473900,"Musée des Mines de fer de Lorraine",NA,"Rue du Musée","57700","Neufchef","France","fr","open",49.325366,6.02815101027397,15234,1460,16694,16309,1372,17681,16237,1884,18121,16736,1579,18315,17601,1585,19186,17406,1336,18742
"49","9531301","0174561123","http://musee.ville-isle-adam.fr","ÎLE-DE-France","VAL D'OISE",2584777625,"Musée d'Art et d'Histoire Louis Senlecq",NA,"Grande Rue","95290","L'Isle-Adam","France","fr","open",49.1125448,2.2159284,944,3167,4111,744,3684,4428,819,4222,5041,424,1248,1672,1916,4948,6864,2540,7177,9717
"50","7510709","0156617000","www.quaibranly.fr","ÎLE-DE-France","PARIS",17954721,"Musée du Quai Branly - Jacques Chirac","37","Quai Branly","75007","Paris","France","fr","open",48.8609943,2.29796963519583,564215,697602,1261817,546417,627297,1173714,284726,626119,910845,317688,716938,1034626,422920,765194,1188114,334417,735042,1069459
"51","7623101","0232963040","www.la-crea.fr ou Site des musées de la région","NORMANDIE","SEINE-MARITIME",6125652532,"Musée d'Elbeuf","7","Cours Gambetta","76500","Elbeuf","France","fr","open",49.2849932,1.0058403,6223,16869,23092,7272,18091,25363,0,65248,65248,0,37685,37685,0,37816,37816,2933,29608,32541
"52","3919801","0384792585","Site de la ville ou site des musées de la région","BOURGOGNE-FRANCHE-COMTE","JURA",946483217,"Musée des Beaux-Arts",NA,"Rue des Arènes","39100","Dole","France","fr","open",47.0896386,5.4891469,0,23507,23507,0,22149,22149,0,20692,20692,0,18229,18229,0,24952,24952,0,21681,21681
"53","6938901","0472175454","www.museepompiers.com/","AUVERGNE-RHÔNE-ALPES","RHÔNE",125076993,"Musée des Sapeurs-Pompiers de Lyon",NA,"Avenue de Lanessan","69009","Lyon","France","fr","open",45.7912535,4.79852564190976,5439,5241,10680,4517,7311,11828,3776,5477,9253,4063,4371,8434,4058,2486,6544,3233,1813,5046
"54","1803303","0248578115","site de la ville www.ville-bourges.fr","CENTRE-VAL DE LOIRE","CHER",64604953,"Musée du Berry","4","Rue des Arènes","18000","Bourges","France","fr","open",47.08530015,2.39267207904075,28893,4636,33529,6007,2597,8604,0,14160,14160,0,15106,15106,0,16313,16313,0,13613,13613
"55","5746302","0387201320","www.musee.metzmetropole.fr","GRAND EST","MOSELLE",63234063,"Musées de la Cour d'Or",NA,"Rue de la Boucherie Saint-George","57045","Metz","France","fr","open",49.1213164,6.17852510069008,24869,33541,58410,22607,23256,45863,32184,10163,42347,18999,22686,41685,23863,25641,49504,18732,26174,44906
"56","9202301","0145342263","www.fondationarp.org","ÎLE-DE-France","HAUTS DE SEINE",29036,"Fondation Arp",NA,NA,"92140","Clamart","France","fr","open",48.800368,2.2630292,1821,1185,3006,1620,574,2194,997,1070,2067,927,1522,2449,1303,449,1752,1579,423,2002
"57","6121401","0233241240","www.ville-laigle.fr","NORMANDIE","ORNE",2006338406,"Musée Municipal d'Archéologie","12","Rue Joseph Rey","38000","Grenoble","France","fr","open",45.1861012,5.7170417,370,607,977,483,948,1431,365,619,984,438,631,1069,832,419,1251,527,397,924
"58","5021803","0233614821","www.musee-dior-granville.com","NORMANDIE","MANCHE",135528003,"Musée Christian Dior",NA,"Rue du Docteur Ollivier","50400","Granville","France","fr","open",48.8429745,-1.59254348148148,49563,7439,57002,48464,7851,56315,37418,6586,44004,32969,5580,38549,35509,4801,40310,48238,0,48238
"59","6410201","0559590898","www.musee-basque.com","NOUVELLE-AQUITAINE","PYRÉNÉES ATLANTIQUES",631661850,"Musée Basque et de l'Histoire de Bayonne","37","Quai des Corsaires","64100","Bayonne","France","fr","open",43.4910854,-1.473799,20874,43592,64466,22787,39359,62146,26348,34927,61275,20179,26749,46928,15793,21809,37602,16196,21884,38080
"60","0415801","0492740959","www.museeprehistoire.com","PROVENCE-ALPES-CÔTE D'AZUR","ALPES DE HAUTE PROVENCE",88754715,"Musée départemental de préhistoire",NA,"Route de Montmeyan","04500","Quinson","France","fr","open",43.69970475,6.03711834431034,62629,11994,74623,63151,10851,74002,58433,11552,69985,58658,12702,71360,58502,9915,68417,60634,9601,70235
"61","7654010","0235073174","http://museedelaceramique.fr","NORMANDIE","SEINE-MARITIME",4403230180,"Musée de la Céramique","1","Rue Faucon","76000","Rouen","France","fr","open",49.4455129,1.0936222,10046,0,10046,19776,5518,25294,1108,8531,9639,3244,3595,6839,2769,3370,6139,3681,4099,7780
"62","3306701","0557682357","Site des musées d'aquitaine","NOUVELLE-AQUITAINE","GIRONDE",3594252315,"Musée de la Voiture à Cheval. Au temps des calèches",NA,"Rue du Roc","33710","Bourg","France","fr","open",45.0389607,-0.5614182,1994,1504,3498,3017,1909,4926,1101,1395,2496,1865,1207,3072,1999,965,2964,1879,770,2649
"63","2123102","0380488370","Site des musées de Bourgogne - www.musees-bourgogne.org","BOURGOGNE-FRANCHE-COMTE","CÔTE D’OR",1493118991,"Musée Archéologique",NA,"Place Saint-Bénigne","21000","Dijon","France","fr","open",47.3216174,5.0348411,0,38942,38942,0,22776,22776,0,33119,33119,0,34528,34528,0,29833,29833,0,27409,27409
"64","6938501","0478420361","www.gadagne.musees.lyon.fr","AUVERGNE-RHÔNE-ALPES","RHÔNE",700244364,"Musées Gadagne",NA,"Rue de la Fronde","69005","Lyon","France","fr","open",45.7640445,4.82728874210309,31545,47317,78862,32200,42685,74885,46729,32720,79449,27710,44006,71716,45069,55230,100299,46636,58497,105133
"65","5626002","0297016300",NA,"BRETAGNE","MORBIHAN",145189774,"Musée d'Histoire et d'Archéologie de Vannes","2","Rue Noé","56000","Vannes","France","fr","open",47.6568685,-2.75798382246377,3034,7228,10262,2679,4575,7254,2817,4276,7093,1910,4063,5973,1822,3478,5300,2162,4507,6669
"66","6923501","0474537401","En cours de réactualisation en 2017 - ouverture prévue en 2017","AUVERGNE-RHÔNE-ALPES","RHÔNE",131339006,"Musée Archéologique",NA,"D 502","69560","Saint-Romain-en-Gal","France","fr","open",45.5291012,4.8704538527402,22722,53684,76406,23693,51100,74793,24799,52189,76988,20782,48909,69691,22595,57839,80434,21758,60495,82253
"67","6311303","0473423200","www.clermont-ferrand.fr/-Museum-Henri-Lecoq-.html","AUVERGNE-RHÔNE-ALPES","PUY DE DÔME",67552132,"Muséum d'Histoire Naturelle Henri-Lecoq","15","Rue Bardoux","63000","Clermont-Ferrand","France","fr","open",45.77414595,3.0884366874758,4480,25135,29615,7645,37141,44786,4595,26750,31345,5005,24745,29750,2884,21238,24122,3177,19645,22822
"68","6730001","0388495938","www.chartreuse-molsheim.info","GRAND EST","BAS-RHIN",58887086,"Musée de la Chartreuse",NA,"Rue des Étudiants","67120","Molsheim","France","fr","open",48.5428428,7.49042212336198,5367,1596,6963,4641,2053,6694,4199,2239,6438,4119,1318,5437,4119,1331,5450,4105,862,4967
"69","7510303","0153018653","www.mahj.org","ÎLE-DE-France","PARIS",56687783,"Musée d'Art et d'Histoire du Judaïsme",NA,"Passage Sainte-Avoie","75003","Paris","France","fr","open",48.8612664,2.35544164764573,69157,43361,112518,58587,40920,99507,52721,31983,84704,55380,35848,91228,78506,44362,122868,79340,38304,117644
"70","7510403","0155425010","www.crypte.paris.fr","ÎLE-DE-France","PARIS",159896046,"Crypte Archéologique du Parvis Notre-Dame",NA,"Parvis Notre-Dame - Place Jean-Paul II","75004","Paris","France","fr","open",48.85354265,2.34819811637647,39069,117206,156275,46221,124969,171190,51296,127623,178919,165628,0,165628,53211,144829,198040,68662,154737,223399
"71","7904201","0549051213","www.deux-sevres.com/musee-bougon","NOUVELLE-AQUITAINE","DEUX-SEVRES",1405861,"Musée des Tumulus de Bougon",NA,"Route de Pamproux","79800","Bougon","France","fr","open",46.3779715,-0.067125642746785,13965,2711,16676,13553,2852,16405,12574,4488,17062,14190,5401,19591,12887,5864,18751,10876,6511,17387
"72","4729201","0553407303","www.sauveterre-prehistoire.fr ou www.tourisme-fumelois.fr","NOUVELLE-AQUITAINE","LOT ET GARONNE",5827779554,"Musée de Préhistoire Mésolithique Laurent Coulonges",NA,"D 68","47500","Sauveterre-la-Lémance","France","fr","open",44.5904194,1.0137463,2350,372,2722,2324,326,2650,2222,379,2601,2375,334,2709,2709,206,2915,2836,663,3499
"73","1120601","0468318503","www.limoux.fr/fr/tourisme/musee_petiet.html","OCCITANIE","AUDE",799714487,"Musée Petiet",NA,"Avenue Fabre d'Églantine","11300","Limoux","France","fr","open",43.0534043,2.2144622,709,2717,3426,474,2046,2520,467,2549,3016,846,1808,2654,900,1745,2645,590,2206,2796
"74","1214501","0565590108","www.millauculture.fr ou www.ot-millau.fr","OCCITANIE","AVEYRON",187705210,"Musée Municipal de Millau",NA,"Rue de la Madeleine","12620","Saint-Beauzély","France","fr","open",44.164187,2.9579286798419,10480,8836,19316,4774,6339,11113,3303,13380,16683,3440,14317,17757,8927,8052,16979,4501,15461,19962
"75","4410904","0811464644","www.château-nantes.fr","PAYS DE LA LOIRE","LOIRE-ATLANTIQUE",6808838,"Musée du Château des Ducs de Bretagne","4","Place Marc Elder","44000","Nantes","France","fr","open",47.21609735,-1.5499958913608,148735,184005,332740,94794,175448,270242,79692,152032,231724,91337,147117,238454,127097,138367,265464,80509,99563,180072
"76","1038707","0325809897","www.musees-troyes.com","GRAND EST","AUBE",6454674,"Pharmacie Musée de l'Hôtel-Dieu",NA,"Rue de la Cité","10000","Troyes","France","fr","open",48.29898965,4.07850115359695,1196,4869,6065,4437,7961,12398,3640,7847,11487,3411,7428,10839,2603,6966,9569,2834,6234,9068
"77","0805301","0324271586","www.maisondeladernierecartouche.com","GRAND EST","ARDENNES",1874188907,"Musée de la Maison de la Dernière Cartouche",NA,"Avenue de la Dernière Cartouche","08140","Bazeilles","France","fr","open",49.6817859,4.9754729,1175,1388,2563,1029,1344,2373,1044,984,2028,924,724,1648,1043,960,2003,1173,865,2038
"78","6748203","0388525000","www.musees.strasbourg.eu","GRAND EST","BAS-RHIN",239830896,"Musée des Beaux-Arts",NA,"Place du Marché aux Poissons","67065","Strasbourg","France","fr","open",48.5806606,7.7521404,34680,39061,73741,32087,34446,66533,29610,30636,60246,32920,41059,73979,27783,25053,52836,29946,25888,55834
"79","6748213","0369063727","www.musees-strasbourg.eu","GRAND EST","BAS-RHIN",486650189,"Musée Tomi Ungerer",NA,"Rue Joseph Massol","67073","Strasbourg","France","fr","open",48.58570885,7.75503698999828,25000,25000,50000,22411,22430,44841,21732,22655,44387,22853,25758,48611,20175,20566,40741,19511,29410,48921
"80","5912201","0327822790","www.villedecambrai.com/culture/musee.html","HAUTS-DE-France","NORD",6098585497,"Musée Municipal de Cambrai","15","Rue de l'Épée","59400","Cambrai","France","fr","open",50.1734096,3.2299021,706,7885,8591,1293,8662,9955,2849,8602,11451,1792,9551,11343,2784,10654,13438,1883,13749,15632
"81","5952601","0327222693","Site de la ville","HAUTS-DE-France","NORD",2060779461,"Musée de la Tour Abbatiale",NA,"Grand'Place","59230","Saint-Amand-les-Eaux","France","fr","open",50.4489646,3.4287208,0,8536,8536,0,10038,10038,0,17683,17683,0,13308,13308,0,13063,13063,0,14550,14550
"82","4205203","0477602884","http://www.ville-charlieu.fr/avoir/musees/le-musee-hospitalier","AUVERGNE-RHÔNE-ALPES","LOIRE",2959298116,"Musée Hospitalier",NA,"Rue Jean Morel","42190","Charlieu","France","fr","open",46.159575,4.1712806,0,0,0,2630,837,3467,2711,929,3640,2152,1019,3171,3114,1562,4676,2633,1431,4064
"83","7510905","0155319567","www.vie-romantique.paris.fr","ÎLE-DE-France","PARIS",84511123,"Musée de la Vie Romantique","16","Rue Chaptal","75009","Paris","France","fr","open",48.88120505,2.3335393830115,0,62132,62132,97165,0,97165,36318,81688,118006,13826,74522,88348,7359,67834,75193,6455,69212,75667
"84","7511617","0156528600","www.palaisgalliera.paris.fr","ÎLE-DE-France","PARIS",1191057,"Palais Galliera - Musée de la Mode de la ville de Paris","10","Avenue Pierre 1er de Serbie","75116","Paris","France","fr","open",48.8657028,2.29650642539781,59211,30583,89794,97830,41928,139758,107948,46313,154261,174109,8121,182230,160135,56726,216861,70622,257935,328557
"85","2746701","0232568481","www.ville-pont-audemer.fr ou www.musee-haute-normandie.fr","NORMANDIE","EURE",182904946,"Musée Alfred Canel","64","Rue de la République","27500","Pont-Audemer","France","fr","open",49.3566785,0.5159406375,663,5217,5880,690,4829,5519,718,6205,6923,571,5049,5620,501,4948,5449,324,6145,6469
"86","1300104","0442528832","www.museegranet-aixenprovence.fr","PROVENCE-ALPES-CÔTE D'AZUR","BOUCHES DU RHONE",34505703,"Musée Granet",NA,"Rue Cardinale","13626","Aix-en-Provence","France","fr","open",43.5254678,5.4526102,108111,68951,177062,81946,59132,141078,109825,65652,175477,96135,70387,166522,135560,63793,199353,249072,97724,346796
"87","7127002","0385399038","http://www.macon.fr/Culture-sports-et-loisirs/Les-Musees-de-Macon","BOURGOGNE-FRANCHE-COMTE","SAONE ET LOIRE",700244362,"Musée Lamartine",NA,"Rue des Ursulines","71000","Saint-Clément","France","fr","open",46.307027,4.83314219713088,0,0,0,0,0,0,633,2317,2950,1285,3557,4842,1440,4032,5472,1286,4092,5378
"88","8944601","0386323926","www.musee-zervos.fr","BOURGOGNE-FRANCHE-COMTE","YONNE",2628533133,"Musée Zervos - Maison Romain Rolland",NA,NA,"89450","Vézelay","France","fr","open",47.4638215,3.743302,4903,2912,7815,6032,3626,9658,4384,2534,6918,7766,2405,10171,6128,2939,9067,2110,6766,8876
"89","6047101","0344094341","www.ville-noyon.fr/Le-musee-du-Noyonnais.html","HAUTS-DE-France","OISE",2403483347,"Musée du Noyonnais",NA,"Rue de l'Évéché","60400","Noyon","France","fr","open",49.5815691,3.0004427,990,1532,2522,927,1576,2503,770,1908,2678,1221,1990,3211,1402,1921,3323,1022,1318,2340
"90","7728802","0164797770","Site de la ville : www.ville-melun.fr","ÎLE-DE-France","SEINE ET MARNE",112363959,"Musée d'Art et d'Histoire de Melun","1-3","Rue Émile Leclerc","77000","Melun","France","fr","open",48.54554555,2.65291193463687,2760,9930,12690,504,3780,4284,502,3524,4026,549,6209,6758,506,5937,6443,791,5880,6671
"91","1437001","0231228910","www.ville-molay-littry.fr","NORMANDIE","CALVADOS",8193839563,"Musée de la Mine",NA,"Rue de la Fosse Frandemiche","14330","Le Molay-Littry","France","fr","open",49.2426092,-0.8788501,1907,799,2706,1920,457,2377,2014,731,2745,3287,879,4166,3297,894,4191,3314,1168,4482
"92","0401901","0492812715","site de la ville - www.barcelonnette.com","PROVENCE-ALPES-CÔTE D'AZUR","ALPES DE HAUTE PROVENCE",5820118153,"Musée de la vallée",NA,"D 25","04530","Les Prats","France","fr","open",44.5154275,6.7524549,8541,2668,11209,8589,2255,10844,8240,1344,9584,8901,1791,10692,9702,2982,12684,8960,2424,11384
"93","9120001","0164596683","Site de la ville - www.mairie-dourdan.fr","ÎLE-DE-France","ESSONNE",2650356282,"Musée du Château",NA,"Rue du Marché aux Grains","91410","Dourdan","France","fr","open",48.5298686,2.0111955,6371,9190,15561,11888,10574,22462,11067,9054,20121,9539,8645,18184,10472,7020,17492,7103,5830,12933
"94","0926801","0561048186","www.sites-touristiques-ariege.fr /sites-touristiques-ariege/palais-des-eveques","OCCITANIE","ARIEGE",2833497965,"Musée du Palais des Evêques",NA,"Chemin du Parc","09190","Saint-Lizier","France","fr","open",43.0027248,1.1370459,10134,1414,11548,11121,1276,12397,8705,1459,10164,7966,1160,9126,9426,1391,10817,9644,1637,11281
"95","6444503","0559823800","www.musee-chateau-pau.fr","NOUVELLE-AQUITAINE","PYRÉNÉES ATLANTIQUES",6815484814,"Musée National du Château",NA,"Rue Mathieu Lalanne","64000","Pau","France","fr","open",43.2977315,-0.3645267,51062,45026,96088,53051,46564,99615,49921,43826,93747,50080,45351,95431,42315,44333,86648,52299,38269,90568
"96","3901301","0384374790","Site des musées de la région","BOURGOGNE-FRANCHE-COMTE","JURA",121753643,"Musée Sarret de Grozon",NA,"Grande Rue","39600","Arbois","France","fr","open",46.902592,5.77428494578313,1297,1714,3011,602,1577,2179,525,1602,2127,461,2268,2729,291,2217,2508,958,1324,2282
"97","6311305","0473161130","http://museedart.clermont-ferrand.fr","AUVERGNE-RHÔNE-ALPES","PUY DE DÔME",67015490,"Musée d'Art Roger-Quillot",NA,"Place Louis Deteix","63100","Clermont-Ferrand","France","fr","open",45.79392705,3.11622231467696,9993,18934,28927,9378,25183,34561,29705,48681,78386,3478,20299,23777,6492,26818,33310,5295,21077,26372
"98","4019401","0558986927","www.museedelachalosse.fr","NOUVELLE-AQUITAINE","LANDES",102618114,"Musée de la Chalosse","480","Chemin du Sala","40380","Montfort-en-Chalosse","France","fr","open",43.71570595,-0.833717228626044,5852,2498,8350,2189,5054,7243,5854,3891,9745,5277,3249,8526,5623,2307,7930,5729,2412,8141
"99","8613701","0549980848","www.alienor.org","NOUVELLE-AQUITAINE","VIENNE",6957982158,"Musée Charbonneau-Lassay",NA,"Rue du Martray","86200","Loudun","France","fr","open",47.0100455,0.0757517,0,2019,2019,0,1626,1626,0,1020,1020,0,1187,1187,0,1123,1123,0,911,911
"100","3220801","0562687022","site du département : www.gers-gascogne.com","OCCITANIE","GERS",5101531521,"Musée d'Archéologie",NA,"Place du Général de Gaulle","32700","Lectoure","France","fr","open",43.9336845,0.6235845,1901,1718,3619,2033,1452,3485,2247,1245,3492,1376,1036,2412,1436,1263,2699,1752,938,2690
"101","1320691","0491250107","www.mairie-marseille.fr/vivre/culture/musees.htm","PROVENCE-ALPES-CÔTE D'AZUR","BOUCHES DU RHONE",168685674,"Musée d'Art Contemporain - Galeries Contemporaines","7","Promenade Robert Laffont","13002","Marseille","France","fr","open",43.29672875,5.36102547336816,7920,16428,24348,12188,35248,47436,14694,5847,20541,21740,25397,47137,8926,18945,27871,10842,16329,27171
"102","4221901","0477975468","www.loire.fr","AUVERGNE-RHÔNE-ALPES","LOIRE",224220352,"Château de la Bastie d'Urfé",NA,"Route de la Batie D'urfe","42130","Saint-Étienne-le-Molard","France","fr","open",45.72759345,4.07835434333168,7278,20199,27477,7721,18079,25800,8012,19873,27885,7824,18519,26343,8483,19779,28262,15157,9999,25156
"103","7107602","0385484198","www.museeniepce.com","BOURGOGNE-FRANCHE-COMTE","SAONE ET LOIRE",121572642,"Musée Nicéphore Niepce",NA,"Quai des Messageries","71100","Chalon-sur-Saône","France","fr","open",46.7802664,4.85545725932731,0,26585,26585,0,27530,27530,0,24772,24772,0,25385,25385,0,27180,27180,0,26183,26183
"104","6410203","0559591510","www.museum.bayonne.fr","NOUVELLE-AQUITAINE","PYRÉNÉES ATLANTIQUES",72680932,"Muséum d'Histoire Naturelle",NA,"Chemin d'Ansot","64100","Bayonne","France","fr","open",43.474313,-1.478051,0,27400,27400,0,23495,23495,0,31398,31398,0,20800,20800,0,23900,23900,0,21372,21372
"105","0319001","0470204847","www.mab.allier.fr","AUVERGNE-RHÔNE-ALPES","ALLIER",77184178,"Musée Anne de Beaujeu",NA,"Rue des Fausses Braies","03000","Moulins","France","fr","open",46.56717035,3.33006168367599,18081,11972,30053,14721,14400,29121,14178,14784,28962,10428,13207,23635,19111,8923,28034,20143,3153,23296
"106","6901801","0474692288","www.beaujolaisvignoble.com","AUVERGNE-RHÔNE-ALPES","RHÔNE",1788408922,"Musée Folklorique et Traditions Populaires Marius Audin","62","Place de l'Hôtel de Ville","69430","Beaujeu","France","fr","open",46.154402,4.5870811,454,494,948,718,463,1181,2717,435,3152,634,646,1280,790,528,1318,865,764,1629
"107","0810503","0324324464","www.mairie-charlevillemezieres.fr/htm/culture/rimbaud.htm","GRAND EST","ARDENNES",1765207774,"Musée de l'Ardenne",NA,"Les Arcades","08000","Charleville-Mézières","France","fr","open",49.77272,4.7214458,5617,39879,45496,6660,45901,52561,5527,30974,36501,4222,44511,48733,4480,45541,50021,5091,41976,47067
"108","7511615","0153674000","www.mam.paris.fr","ÎLE-DE-France","PARIS",79219308,"Musée d'Art Moderne de la ville de Paris",NA,"Rue Gaston de Saint-Paul","75116","Paris","France","fr","open",48.8643133,2.29786022256718,282253,254831,537084,341439,164807,506246,282863,330539,613402,436445,233596,670041,266000,327300,593300,367548,327828,695376
"109","7510802","0144844500","https://philharmoniedeparis.fr/fr/musee-de-la-musique","ÎLE-DE-France","PARIS",5304864568,"Musée de la Musique","221","Avenue Jean Jaurès","75019","Paris","France","fr","open",48.8901928,2.393712,166776,91506,258282,169861,80955,250816,182877,91282,274159,297151,82643,379794,125789,44834,170623,148660,50561,199221
"110","1411804","0231060644","www.memorial-caen.fr","NORMANDIE","CALVADOS",6465290615,"Mémorial de Caen",NA,"Cours des Français Libres","14000","Caen","France","fr","open",49.1985281,-0.3834794,334917,54521,389438,319707,52045,371752,300531,48924,349455,328654,55304,383958,438998,0,438998,286696,50090,336786
"111","3415801","0468912292",NA,"OCCITANIE","HERAULT",2622894330,"Musée Archéologique",NA,"Place du Monument","34210","Minerve","France","fr","open",43.3543868,2.7460475,3275,0,3275,3768,0,3768,3982,0,3982,4278,0,4278,4035,0,4035,4118,0,4118
"112","0606902","0493368020","www.museesdegrasse.fr","PROVENCE-ALPES-CÔTE D'AZUR","ALPES-MARITIMES",68051130,"Musée d'Art et d'Histoire de Provence",NA,"Place Mariejol","06600","Antibes","France","fr","open",43.58070895,7.12825961788498,3697,6434,10131,2431,9465,11896,1738,12181,13919,0,20080,20080,0,18334,18334,0,20701,20701
"113","6319501","0473734242","www.puydedome.fr rubrique ""découvrir le Puy-de-Dôme""","AUVERGNE-RHÔNE-ALPES","PUY DE DÔME",700609620,"Musée Départemental de la Céramique Gallo-Romaine",NA,"Rue du Musée","63190","Lezoux","France","fr","open",45.82572555,3.38474400658784,7590,3871,11461,5518,4108,9626,5910,5178,11088,5133,3691,8824,8485,4839,13324,6673,4762,11435
"114","7511402","0143224763","www.catacombes.paris.fr","ÎLE-DE-France","PARIS",493870538,"Les Catacombes","1","Avenue du Colonel Henri Rol Tanguy","75014","Paris","France","fr","open",48.8337437,2.3322959,398400,81600,480000,446486,91449,537935,427575,84709,512284,411758,93327,505085,301204,55558,356762,265907,45050,310957
"115","7510519","0140513838","www.imarabe.org","ÎLE-DE-France","PARIS",22870791,"Institut du Monde Arabe","1","Rue des Fossés Saint-Bernard","75005","Paris","France","fr","open",48.84891635,2.3574932625,252267,27100,279367,397952,13763,411715,59064,64596,123660,269940,125802,395742,397611,153837,551448,182806,99694,282500
"116","5307701","0243988089","www.musee-robert-tatin.fr","PAYS DE LA LOIRE","MAYENNE",1305841940,"Musée Communal Robert Tatin",NA,"L'Allée des Géants","53230","Cossé-le-Vivien","France","fr","open",47.9337461,-0.8955996,22285,5568,27853,20958,5056,26014,20709,4916,25625,19554,5054,24608,17818,9158,26976,16889,3963,20852
"117","2415201","0553317100",NA,"NOUVELLE-AQUITAINE","DORDOGNE",4364598320,"Musée Paul Reclus",NA,"Rue Paul Reclus","24250","Domme","France","fr","open",44.8028038,1.2138053,473,6746,7219,436,20485,20921,454,18403,18857,0,18232,18232,0,17590,17590,141,13569,13710
"118","7713201","0160048280","http://www.coupvray.fr/coupvray/acces_direct/louis_braille","ÎLE-DE-France","SEINE ET MARNE",373767052,"Maison Natale de Louis Braille",NA,"Rue Louis Braille","77700","Coupvray","France","fr","open",48.8945027,2.79203363734403,5021,963,5984,4233,817,5050,4406,1417,5823,3130,1752,4882,4698,0,4698,4439,0,4439
"119","3936801","0384333930","www.musee-lunette.fr ou www.musees-franchecomte.com","BOURGOGNE-FRANCHE-COMTE","JURA",486032307,"Viséum-Musée de la Lunette",NA,"Place Jean Jaurès","39400","Morez","France","fr","open",46.5205705,6.0226517,8531,4046,12577,8951,3309,12260,11087,6243,17330,9386,6169,15555,10365,4703,15068,9906,6202,16108
"120","7306503","0479333944","www.chambery.fr/302-les-charmettes-maison-de-jean-jacques-rousseau.htm","AUVERGNE-RHÔNE-ALPES","SAVOIE",101956960,"Musée des Charmettes","890","Chemin des Charmettes","73000","Chambéry","France","fr","open",45.5531438,5.92970844390904,0,13806,13806,0,7265,7265,0,11010,11010,0,11402,11402,0,14618,14618,0,12907,12907
"121","3523802","0223621745","www.mbar.org","BRETAGNE","ILE ET VILAINE",30437810,"Musée des Beaux-Arts","20","Quai Émile Zola","35000","Rennes","France","fr","open",48.1096227,-1.67494123863636,25811,83308,109119,20761,70833,91594,20926,63573,84499,17360,56053,73413,20126,65162,85288,15070,60843,75913
"122","4909901","0272772322","Site de la ville : www.ville-cholet.fr/musee-art-histoire.php","PAYS DE LA LOIRE","MAINE-ET-LOIRE",1782756206,"Musée d'Art et d'Histoire",NA,"Avenue de l’Abreuvoir","49300","Cholet","France","fr","open",47.0583944,-0.8807128,1777,14300,16077,1763,12228,13991,1796,14977,16773,2548,14108,16656,1928,13697,15625,2279,15796,18075
"123","5550202","0329806878","www.musee-de-la-biere.com","GRAND EST","MEUSE",134231670,"Musée de la Bière et du Pays de Stenay","17","Rue du Moulin","55700","Stenay","France","fr","open",49.488919,5.18667592226702,9295,13617,22912,6712,15419,22131,7101,13172,20273,7610,12261,19871,7556,12332,19888,7931,11854,19785
"124","6803601","0389720158","www.ville-biesheim.fr/museegr.html","GRAND EST","HAUT-RHIN",685084692,"Musée Gallo-Romain",NA,"Rue des Capucins","68600","Biesheim","France","fr","open",48.039525,7.5455969,756,1626,2382,632,1272,1904,559,1396,1955,638,1311,1949,598,1414,2012,608,1294,1902
"125","3818501","0476447868","www.musee-archeologique-grenoble.fr","AUVERGNE-RHÔNE-ALPES","ISERE",2323051603,"Musée Archéologique Grenoble Saint-Laurent",NA,"Quai Jongkind","38000","Grenoble","France","fr","open",45.1953352,5.7315819,0,47563,47563,0,46520,46520,0,45005,45005,0,43881,43881,0,43004,43004,0,39777,39777
"126","9306601","0142430510","www.musee-saint-denis.fr","ÎLE-DE-France","SEINE SAINT-DENIS",63992928,"Musée d'Art et d'Histoire",NA,"Avenue Amilcar Cabral","93210","Saint-Denis","France","fr","open",48.91430945,2.36032338442274,3276,12819,16095,12487,4526,17013,3170,14481,17651,2277,12752,15029,2847,17374,20221,2759,17182,19941
"127","9542801","0139648013","http://museejjrousseau.montmorency.fr","ÎLE-DE-France","VAL D'OISE",4459265327,"Musée jean-Jacques Rousseau",NA,"Rue du Mont Louis","95160","Montmorency","France","fr","open",48.9869805,2.3215161,1327,1550,2877,913,838,1751,1294,727,2021,1096,1623,2719,1296,1801,3097,1530,1656,3186
"128","7510405","0142721016","www.maisonsvictorhugo.paris.fr","ÎLE-DE-France","PARIS",254033221,"Maison de Victor Hugo","6","Place des Vosges","75004","Paris","France","fr","open",48.8548144,2.3661103,42429,133246,175675,44859,121221,166080,42214,80974,123188,26980,100219,127199,27591,149355,176946,30252,129906,160158
"129","3600601","0254243469","http://chemiserie.cc-argenton.fr","CENTRE-VAL DE LOIRE","INDRE",2416267792,"Musée de la Chemiserie et de l'Elégance Masculine",NA,"Rue Charles Brillaud","36200","Argenton-sur-Creuse","France","fr","open",46.5884724,1.5182182,2919,3889,6808,2975,3919,6894,3268,3329,6597,3026,4180,7206,3199,4358,7557,3080,4227,7307
"130","3844203","0476886045","www.musee-grande-chartreuse.fr","AUVERGNE-RHÔNE-ALPES","ISERE",4323986447,"Musée de la Grande Chartreuse",NA,"D 103","38380","Saint-Pierre-de-Chartreuse","France","fr","open",45.3499104,5.7915302,31275,1646,32921,35900,1924,37824,35311,1873,37184,35412,1903,37315,52755,2269,55024,40854,2803,43657
"131","4221802","0477497300","www.musee-art-industrie.saint-etienne.fr","AUVERGNE-RHÔNE-ALPES","LOIRE",63340891,"Musée d'Art et d'Industrie","2","Place Louis Comte","42000","Saint-Étienne","France","fr","open",45.4314634,4.38684954103093,16545,14659,31204,19927,20586,40513,21911,19505,41416,21269,25386,46655,27126,21317,48443,24485,20985,45470
"132","1803305","0248653734","www.museum-bourges.net","CENTRE-VAL DE LOIRE","CHER",219021603,"Musée d'Histoire Naturelle Gabriel Foucher",NA,"Rue Leonide Bourges","95430","Butry-sur-Oise","France","fr","open",49.09024075,2.200912995104,21319,12247,33566,17068,13904,30972,12290,22016,34306,14802,15419,30221,15321,19811,35132,26314,5372,31686
"133","3726105","0247216220","www.museecompagnonnage.fr","CENTRE-VAL DE LOIRE","INDRE ET LOIRE",40514601,"Musée du Compagnonnage","2","Place Anatole France","37000","Tours","France","fr","open",47.39641815,0.686993597150271,23214,18980,42194,22511,17525,40036,22874,8346,31220,22641,13543,36184,27806,17145,44951,26217,17016,43233
"134","7115301","0385739200","www.ecomusee-creusot-montceau.fr","BOURGOGNE-FRANCHE-COMTE","SAONE ET LOIRE",2018713809,"Ecomusée de la Communauté Le Creusot-Monceau-Les-Mines",NA,"Rue Jules Guesde","71200","Le Creusot","France","fr","open",46.8055361,4.424299,12135,10004,22139,6008,7797,13805,9821,3546,13367,8967,3322,12289,3863,8201,12064,4662,6517,11179
"135","6017501","0344295150","www.creil.fr","HAUTS-DE-France","OISE",80661332,"Musée Gallé-Juillet",NA,"Place François Mitterrand","60100","Creil","France","fr","open",49.26079415,2.47226786848819,1868,6540,8408,2820,4845,7665,1348,5647,6995,1281,4811,6092,1710,6069,7779,2067,5130,7197
"136","3018907","0466368377","http://www.nimes.fr/index.php?id=282","OCCITANIE","GARD",39707615,"Musée des Cultures Taurines (Annexe musée du Vieux Nîmes)",NA,"Place Abbé Pierre",NA,"Nîmes","France","fr","open",43.8379184,4.36040659845317,3433,7826,11259,16349,0,16349,2738,6735,9473,0,16249,16249,838,8136,8974,850,11598,12448
"137","3155502","0561223144","www.SaintRaymond.toulouse.fr","OCCITANIE","HAUTE-GARONNE",261558997,"Musée Saint-Raymond","1","Place Saint-Sernin","31000","Toulouse","France","fr","open",43.60783095,1.4411195508591,12023,40253,52276,13539,45355,58894,16398,43976,60374,21394,32774,54168,22014,35577,57591,12606,39337,51943
"138","7218101","0243473851","site de la ville - www.ville-lemans.fr","PAYS DE LA LOIRE","SARTHE",31113389,"Musée de Tessé","2","Avenue de Paderborn","72000","Le Mans","France","fr","open",48.01029025,0.203547017945546,8335,13258,21593,17915,10670,28585,15222,13250,28472,16668,12934,29602,13206,12492,25698,14882,10816,25698
"139","0603001","0493940606","www.museebonnard.fr","PROVENCE-ALPES-CÔTE D'AZUR","ALPES-MARITIMES",67152119,"Musée Bonnard",NA,"Rue des Prés","06110","Le Cannet","France","fr","open",43.5764934,7.01992848737712,24050,12950,37000,22317,12017,34334,22613,8794,31407,24625,13135,37760,26197,12168,38365,30397,13027,43424
"140","0609801","0493051325","www.ecomusee-roudoule.fr","PROVENCE-ALPES-CÔTE D'AZUR","ALPES-MARITIMES",149921556,"Ecomusée du Pays de la Roudoule",NA,"Placette de l'Europe","06260","Puget-Rostang","France","fr","open",43.9741388,6.91890315204082,1513,4306,5819,1613,4591,6204,642,9076,9718,1534,0,1534,975,484,1459,1176,677,1853
"141","0113701","0474513242","www.treffort-cuisiat.com/musee.htm","AUVERGNE-RHÔNE-ALPES","AIN",700244363,"Musée Départemental du Revermont",NA,"Rue Principale","01370","Bourg-en-Bresse","France","fr","open",46.30032775,5.38904676115698,2961,8545,11506,2661,8032,10693,1704,7946,9650,2929,7301,10230,3894,7468,11362,4090,6779,10869
"142","2923201","0298954520","www.mbaq.fr","BRETAGNE","FINISTERE",1162498487,"Musée des Beaux-Arts",NA,"Place Saint-Corentin","29000","Quimper","France","fr","open",47.996236,-4.102342,34982,21122,56104,30043,17461,47504,60916,6131,67047,35572,6340,41912,77888,13880,91768,27600,17006,44606
"143","1827901","0248711094","www.ville-vierzon/musee.html","CENTRE-VAL DE LOIRE","CHER",622149606,"Musée Municipal",NA,"Rue de la Société Française","18100","Vierzon","France","fr","open",47.2249147,2.0602204,1634,5190,6824,1315,5262,6577,1449,6603,8052,1573,6104,7677,0,7095,7095,0,7088,7088
"144","6938102","0472101740","www.mba-lyon.fr","AUVERGNE-RHÔNE-ALPES","RHÔNE",2502213077,"Musée des Beaux-Arts",NA,"Rue du Président Édouard Herriot","69001","Lyon","France","fr","open",45.766606,4.834343,143458,156772,300230,194583,161786,356369,172333,162126,334459,107813,193445,301258,104904,246457,351361,116757,214690,331447
"145","3726101","0247641331","www.museum.tours.fr","CENTRE-VAL DE LOIRE","INDRE ET LOIRE",38576800,"Muséum d'Histoire Naturelle","3","Rue du Président Merville","37000","Tours","France","fr","open",47.39461145,0.683690130283912,11487,23096,34583,14650,27445,42095,7999,21310,29309,14083,29338,43421,10476,21449,31925,8303,18367,26670
"146","9202601","0171057792","https://www.ville-courbevoie.fr/culture-loisirs/equipements/musee-roybet-fould.htm","ÎLE-DE-France","HAUTS DE SEINE",82241201,"Musée Roybet Fould","178","Boulevard Saint-Denis","92400","Courbevoie","France","fr","open",48.90043675,2.27185335015174,1089,9099,10188,1041,8722,9763,374,10571,10945,0,11849,11849,0,13122,13122,0,11654,11654
"147","7511616","0155744180","http://maisondebalzac.paris.fr/","ÎLE-DE-France","PARIS",84511129,"Maison de Balzac","47","Rue Raynouard","75016","Paris","France","fr","open",48.85520045,2.28088175910134,0,12700,12700,26751,0,26751,4377,29286,33663,9049,18523,27572,5712,34324,40036,616,43422,44038
"148","3306305","0556482637","www.mairie-bordeaux.fr","NOUVELLE-AQUITAINE","GIRONDE",154772662,"Muséum d'Histoire Naturelle de Bordeaux",NA,"Place Bardineau","33000","Bordeaux","France","fr","open",44.8485045,-0.579989952518792,0,11925,11925,0,14469,14469,0,20936,20936,0,14392,14392,0,22725,22725,0,24774,24774
"149","3400301","0467948251",NA,"OCCITANIE","HERAULT",4134270080,"Musée Agathois","5","Rue de la Fraternité","34300","Agde","France","fr","open",43.3118294,3.4686196,1552,2004,3556,1461,1858,3319,1702,1643,3345,1495,2510,4005,1535,1627,3162,2186,1661,3847
"150","0411101","0492757050","www.musee-de-salagon.com","PROVENCE-ALPES-CÔTE D'AZUR","ALPES DE HAUTE PROVENCE",5921065703,"Musée de Salagon",NA,"D 13","04300","Mane","France","fr","open",43.9352027,5.7592489,26221,6187,32408,26520,6588,33108,25666,5634,31300,26195,5371,31566,29433,6233,35666,35228,0,35228
"151","0602701","0492024730","Site de la ville","PROVENCE-ALPES-CÔTE D'AZUR","ALPES-MARITIMES",63863191,"Musée-Château de Cagnes",NA,"Chemin des Collettes","06800","Cagnes-sur-Mer","France","fr","open",43.6676737,7.15694825232139,13286,10872,24158,13031,7317,20348,14179,9451,23630,16517,7634,24151,16960,8705,25665,18629,13642,32271
"152","7635101","0235196262","www.muma-lehavre.fr","NORMANDIE","SEINE-MARITIME",69981531,"Musée d'Art Moderne André Malraux - MuMa","2","Boulevard Clemenceau","76600","Le Havre","France","fr","open",49.48501735,0.102656666439016,39587,44319,83906,76993,62036,139029,53464,46059,99523,33726,36737,70463,82258,56815,139073,61627,45852,107479
"153","7654005","0235712840","www.rouen-musees.com","NORMANDIE","SEINE-MARITIME",64181527,"Musée des Beaux-Arts",NA,"Esplanade Marcel Duchamp","76000","Rouen","France","fr","open",49.44473675,1.09458188041562,27874,108030,135904,28881,137642,166523,67754,110546,178300,53856,66576,120432,54417,70090,124507,145344,105836,251180
"154","3020202","0466391761","http://www.gard-provencal.com/musees/artsacre.htm","OCCITANIE","GARD",73758873,"Musée Départemental d'Art Sacré du Gard",NA,"Rue Saint-Jacques","30130","Pont-Saint-Esprit","France","fr","open",44.25521465,4.65104364282573,130,8075,8205,169,8804,8973,192,9827,10019,447,9891,10338,99,8979,9078,152,9041,9193
"155","8712601","0555037777","www.musee-rochechouart.com","NOUVELLE-AQUITAINE","HAUTE VIENNE",2861736187,"Musée Départemental d'Art Contemporain",NA,"Place du Château","87600","Rochechouart","France","fr","open",45.821447,0.8190893,9086,7009,16095,8600,6645,15245,7733,5711,13444,7957,6453,14410,7958,5918,13876,7124,5875,12999
"156","8305004","0483081386","http.//musee.artillerie.asso.fr","PROVENCE-ALPES-CÔTE D'AZUR","VAR",2391557653,"Musée de l'Artillerie",NA,"Avenue des Ecoles Militaires","83300","Draguignan","France","fr","open",43.5269481,6.497204,0,16580,16580,0,13546,13546,0,21124,21124,0,14281,14281,0,21421,21421,0,6771,6771
"157","6204102","0321712643","www.musenor.org ou www.arras.fr/culture/musee-des-beaux-arts.html","HAUTS-DE-France","PAS-DE-CALAIS",4519451459,"Musée des Beaux-Arts",NA,"Cour d'Honneur","62000","Arras","France","fr","open",50.292028,2.7736831,50902,27467,78369,26000,49370,75370,13497,25065,38562,76982,0,76982,23687,30725,54412,56170,81097,137267
"158","8516302","0251391042","Site de la ville - www.ville-noirmoutier.fr","PAYS DE LA LOIRE","VENDEE",5624961822,"Musée du Château",NA,"Place d'Armes","85330","Noirmoutier-en-l'Île","France","fr","open",47.0004648,-2.2421269,37826,6055,43881,38435,5246,43681,31537,3788,35325,33551,3643,37194,35643,4456,40099,33212,5483,38695
"159","7510701","0144423877","/www.musee-armee.fr","ÎLE-DE-France","PARIS",130102845,"Musée de l'Armée","129","Rue de Grenelle","75007","Paris","France","fr","open",48.8570374,2.3118779,655058,553141,1208199,667162,509825,1176987,680065,526000,1206065,828467,581724,1410191,1004340,520690,1525030,850889,524135,1375024
"160","2701601","0232543178","www.museenicolaspoussin.fr","NORMANDIE","EURE",822879929,"Musée Municipal Nicolas Poussin",NA,"Rue Sainte-Clotilde","27700","Les Andelys","France","fr","open",49.2459998,1.41970045942564,1809,1612,3421,1911,1149,3060,1667,1219,2886,958,1271,2229,1850,1307,3157,1188,2521,3709
"161","7621701","0235066199","www.mairie-dieppe.fr ou www.musees-haute-normandie.fr","NORMANDIE","SEINE-MARITIME",387891590,"Château-Musée de Dieppe",NA,"Rue de Sygogne","76200","Dieppe","France","fr","open",49.9242089,1.07074351331418,15358,12088,27446,14293,16748,31041,18197,14343,32540,17457,13365,30822,14771,9544,24315,22444,10210,32654
"162","7919104","0549787204","www.agglo-niort.fr/-Musee-Bernard-d-Agesci","NOUVELLE-AQUITAINE","DEUX-SEVRES",795257552,"Musée Bernard d’Agesci","26","Avenue de Limoges","79000","Niort","France","fr","open",46.3210536,-0.454416,5756,10476,16232,6200,12057,18257,4064,9136,13200,3610,8890,12500,3718,6658,10376,3845,7535,11380
"163","2403701","0553630413","http://www.bergerac.fr/EspCulture/sitetabac/index.htm","NOUVELLE-AQUITAINE","DORDOGNE",369318223,"Musée du Tabac",NA,"Place du Feu","24100","Bergerac","France","fr","open",44.84971,0.4837602,3681,1455,5136,4092,1298,5390,3606,1187,4793,4213,1275,5488,4014,1490,5504,4270,1542,5812
"164","3805301","0474281974","www.bourgoinjallieu.fr/culture/musee","AUVERGNE-RHÔNE-ALPES","ISERE",120266165,"Musée de Bourgoin-Jallieu","17","Rue Victor Hugo","38300","Bourgoin-Jallieu","France","fr","open",45.586719,5.27930625904977,4695,5234,9929,3038,5097,8135,566,7533,8099,498,10270,10768,2991,6088,9079,2512,6283,8795
"165","7510508","0140795601","www.mnhn.fr","ÎLE-DE-France","PARIS",7444,"Galerie d'Anatomie Comparée et de Paléontologie (Muséum d'Histoire Naturelle)",NA,NA,NA,"Paris","France","fr","open",48.8566969,2.3514616,101280,160425,261705,128593,188138,316731,113003,172357,285360,119627,179439,299066,121711,196071,317782,105794,179365,285159
"166","6406201","0559056171","www.museearudy.com ou www.ot-arudy.fr","NOUVELLE-AQUITAINE","PYRÉNÉES ATLANTIQUES",4335473543,"Musée Municipal",NA,"Rue du Tennis","64260","Arudy","France","fr","open",43.1016426,-0.4297682,997,435,1432,1265,332,1597,1136,917,2053,1359,544,1903,905,770,1675,1075,1071,2146
"167","3225601","0562666810","site du département : www.gers-gascogne.com","OCCITANIE","GERS",2923353853,"Musée des Beaux-Arts et des Arts Décoratifs",NA,"Rue de l'Évêché","32300","Mirande","France","fr","open",43.5153164,0.40345,0,2171,2171,0,3015,3015,3013,0,3013,53,1493,1546,519,90,609,519,340,859
"168","2406401","0553058063","Site des musées aquitains ou http://www.perigord-dronne-belle.fr","NOUVELLE-AQUITAINE","DORDOGNE",5089643323,"Musée Fernand Desmoulin",NA,"Boulevard Charlemagne","24310","Nontron","France","fr","open",45.3641641,0.6468008,31538,4300,35838,26000,3000,29000,21466,3138,24604,19490,2716,22206,20348,2115,22463,19670,2670,22340
"169","3854401","0474852035","www.musees-vienne.fr  Site du patrimoine de l'Isère","AUVERGNE-RHÔNE-ALPES","ISERE",3034478021,"Musée-Cloître Saint-André-Le-Bas",NA,"Avenue de la Libération","87240","Ambazac","France","fr","open",45.9575558,1.4001491,4369,5620,9989,3066,3964,7030,3568,3788,7356,3606,4103,7709,4364,7140,11504,3905,4103,8008
"170","4508201","0238468446","www.chateauneuf-sur-loire.com ou www.musees-centre.com","CENTRE-VAL DE LOIRE","LOIRET",91175188,"Musée de la Marine de Loire",NA,"Allée de Lamballe","45110","Châteauneuf-sur-Loire","France","fr","open",47.864703,2.21730672972973,8245,4967,13212,8932,6049,14981,7429,4900,12329,7068,6159,13227,8480,3331,11811,7403,3769,11172
"171","7126301","0385760341","www.ecomusee-de-la-bresse.com ou site des musées de Bourgogne","BOURGOGNE-FRANCHE-COMTE","SAONE ET LOIRE",372835947,"""L'Atelier d'un Journal"""" de Louhans - Musée Municipal""",NA,"Rue du Musée","71440","Thurey","France","fr","open",46.7430242,5.1227339,2016,3583,5599,1697,3151,4848,1521,2717,4238,1675,3360,5035,1496,3531,5027,1635,4174,5809
"172","4610202","0565503108","www.musee-champollion.fr","OCCITANIE","LOT",68383015,"Musée Champollion - Les Ecriture du Monde",NA,"Impasse Champollion","46100","Figeac","France","fr","open",44.60972575,2.03447121779781,29608,8738,38346,25946,13376,39322,35003,5362,40365,37887,11558,49445,32146,9140,41286,28935,11353,40288
"173","3950001","0384731092","www.salinesdessalins.com ou www.musees-des-techniques.org","BOURGOGNE-FRANCHE-COMTE","JURA",151950172,"Musée des Salines",NA,"Place des Salines","39110","Salins-les-Bains","France","fr","open",46.9376405,5.87615719357903,56650,5407,62057,58631,5216,63847,60297,5036,65333,61992,5509,67501,63837,5873,69710,68194,6371,74565
"174","6301001","0473950003","www.arlanc.fr/dentelle/index.php","AUVERGNE-RHÔNE-ALPES","PUY DE DÔME",4008056943,"Musée de la Dentelle",NA,"Ancienne Route Nationale","63220","Arlanc","France","fr","open",45.4143324,3.7244768,967,119,1086,1213,133,1346,1096,73,1169,728,52,780,983,37,1020,838,11,849
"175","4200301","0477656099","www.museealicetaverne.fr","AUVERGNE-RHÔNE-ALPES","LOIRE",3667424925,"Musée Alice Taverne","89","Rue de la Grye","42820","Ambierle","France","fr","open",46.1054907,3.8958563,3952,1133,5085,3900,750,4650,3493,741,4234,3542,907,4449,3302,920,4222,3375,673,4048
"176","7134201","0385817972","www.musee-hieron.fr","BOURGOGNE-FRANCHE-COMTE","SAONE ET LOIRE",121382168,"Musée Eucharistique du Hiéron","13","Rue de la Paix","71600","Paray-le-Monial","France","fr","open",46.45203975,4.12306320795283,4443,5891,10334,4050,6895,10945,3329,5886,9215,4116,5079,9195,4955,5122,10077,3593,3518,7111
"177","2915502","0298488070","www.pnr-armorique.fr","BRETAGNE","FINISTERE",2139061354,"Musée des Phares et Balises",NA,"Route du Phare",NA,"Lampaul","France","fr","open",48.4594493,-5.1294058,15883,2521,18404,13850,1679,15529,14196,2104,16300,12358,3212,15570,13877,2812,16689,12869,2747,15616
"178","0269101","0323069392","http://www.saint-quentin.fr/1634-nouveau-musee-des-papillons.htm","HAUTS-DE-France","AISNE",447567433,"Musée Entomologique",NA,"Rue Antoine Lécuyer","02100","Saint-Quentin","France","fr","open",49.8499358,3.2849588,4801,10690,15491,0,6115,6115,0,22896,22896,1066,3487,4553,3741,4609,8350,3545,5788,9333
"179","5935002","0320067800","www.pba-lille.fr ou site de la mairie http://www.mairie-lille.fr","HAUTS-DE-France","NORD",152835085,"Palais des Beaux-Arts de Lille",NA,"Place de la République","59000","Lille","France","fr","open",50.63045815,3.06281109444445,107831,149995,257826,106189,147628,253817,109940,141750,251690,152093,148980,301073,129994,134682,264676,225800,0,225800
"180","7710801","0164726580","www.chelles.fr/Culture/Musee-Alfred-Bonno","ÎLE-DE-France","SEINE ET MARNE",1564237,"Musée Municipal de Chelles Alfred Bonno",NA,"Rue Louis Eterlet","77500","Chelles","France","fr","open",48.8778455,2.59114388227884,0,3121,3121,0,3085,3085,0,3472,3472,0,2806,2806,0,2429,2429,0,3150,3150
"181","7674201","0235567831","www.museevictorhugo.fr","NORMANDIE","SEINE-MARITIME",479793340,"Musée Victor Hugo",NA,"Véloroute du Val de Seine","76490","Rouen","France","fr","open",49.5243684,0.72220768522999,6125,7660,13785,5193,6919,12112,4689,7147,11836,5378,7352,12730,4960,7543,12503,4900,7802,12702
"182","8109903","0563410381","site de la ville","OCCITANIE","TARN",1794967900,"Musée de l'Abbaye Saint-Michel",NA,"Petite Rue Saint-Michel","81600","Gaillac","France","fr","open",43.8969758,1.8960647,1640,685,2325,1534,737,2271,1655,749,2404,1240,751,1991,1449,1422,2871,1905,936,2841
"183","1518702","0471604499","www.musee-douet.com","AUVERGNE-RHÔNE-ALPES","CANTAL",243472225,"Musée d'art et d'histoire Alfred Douët",NA,"Place d'Armes","15100","Saint-Flour","France","fr","open",45.0340635,3.0951917871741,1328,2749,4077,1280,1751,3031,1272,1359,2631,1000,1035,2035,934,1352,2286,1126,1407,2533
"184","5746303","0387155277","www.centrepompidou-metz.fr","GRAND EST","MOSELLE",2548561598,"Centre Pompidou de Metz (collections nationales decentralisées)",NA,"Rue de Metz","68100","Mulhouse","France","fr","open",47.7492151,7.3421852,138546,193639,332185,169007,176542,345549,148792,151797,300589,198430,132286,330716,210000,140000,350000,113838,221162,335000
"185","7832201","0139564864","www.museedelatoiledejouy.fr","ÎLE-DE-France","YVELINES",413276082,"Musée de la Toile de Jouy","54","Rue Charles de Gaulle","78350","Les Loges-en-Josas","France","fr","open",48.76918135,2.15208657037636,7047,2458,9505,6200,3554,9754,6877,3213,10090,8306,3696,12002,8259,2471,10730,6072,1124,7196
"186","0918101","0561699722","www.sites-touristiques-ariege.fr","OCCITANIE","ARIEGE",3127357651,"Musée de la Préhistoire",NA,"Place de l'Église","09290","Le Mas-d'Azil","France","fr","open",43.0800307,1.3600366,32526,2914,35440,10741,565,11306,12666,546,13212,12926,838,13764,13761,911,14672,13381,1044,14425
"187","8607001","0549463545","www.chauvigny-patrimoine.fr","NOUVELLE-AQUITAINE","VIENNE",7280016472,"Musée des Traditions Populaires et d'Archéologie",NA,"Impasse Saint-Martial","86300","Chauvigny","France","fr","open",46.5705939,0.6481047,5962,1942,7904,6788,1535,8323,7164,2028,9192,7282,2272,9554,6519,2414,8933,6335,2229,8564
"188","0615901","0493763327","www.villefranche-sur-mer.org","PROVENCE-ALPES-CÔTE D'AZUR","ALPES-MARITIMES",1297270381,"Musées de la Citadelle",NA,"Fossés de la Citadelle","06230","Villefranche-sur-Mer","France","fr","open",43.7017095,7.310623,0,45958,45958,0,61428,61428,0,89493,89493,0,82793,82793,0,77262,77262,0,95866,95866
"189","9001002","0384904070","www.musees-franchecomte.com","BOURGOGNE-FRANCHE-COMTE","TERRITOIRE DE BELFORT",79763460,"Donation Maurice Jardot","8","Rue de Mulhouse","90000","Belfort","France","fr","open",47.6427099,6.85572397778344,945,6004,6949,1245,5381,6626,1007,6216,7223,7347,0,7347,8236,0,8236,6491,0,6491
"190","4227901","0477520311","www.stjust-strambert.fr","AUVERGNE-RHÔNE-ALPES","LOIRE",2471969138,"Musée des Civilisations : Daniel Pouget",NA,"Square de la Résistance","42170","Saint-Just-Saint-Rambert","France","fr","open",45.5008625,4.2426518,3926,1992,5918,4218,1107,5325,4452,1281,5733,6399,4750,11149,3699,3605,7304,3655,5222,8877
"191","8025301","0322770007","www.mairie-doullens.fr","HAUTS-DE-France","SOMME",53222058,"Musée Lombart",NA,"Rue du Musée","80600","Doullens","France","fr","open",50.1546836,2.3437442,190,4173,4363,302,3939,4241,185,3970,4155,156,4147,4303,143,4047,4190,261,4958,5219
"192","8062001","0322733110","Site internet de la ville www.ville-peronne.fr ou http://www.haute-somme.com/danicourt/","HAUTS-DE-France","SOMME",193012404,"Musée Alfred Danicourt",NA,"Rue de la Résistance","80200","Péronne","France","fr","open",49.929138,2.93060001381109,0,2263,2263,0,2352,2352,0,3903,3903,0,2468,2468,0,3127,3127,0,2259,2259
"193","6100101","0233324007","www.paysdalencontourisme.com/musee-beaux-arts-dentelle-alencon_784_fr.html","NORMANDIE","ORNE",1511784502,"Musée des Beaux-Arts et de la Dentelle",NA,"Passage de la Porte de Lancrel","61000","Alençon","France","fr","open",48.4316406,0.0835809,7719,6992,14711,7965,6117,14082,8852,7583,16435,8663,7171,15834,9969,8211,18180,8066,5973,14039
"194","8403501","0490760034","www.cavaillon.org","PROVENCE-ALPES-CÔTE D'AZUR","VAUCLUSE",5111377213,"Synagogue Musée Juif Comtadin",NA,"Rue Hébraïque","84300","Cavaillon","France","fr","open",43.8371707,5.0385983,3491,1644,5135,3063,2070,5133,3163,1597,4760,2292,1719,4011,3108,1758,4866,2861,1995,4856
"195","0240802","0323228700","http://ca-paysdelaon.fr/musee.html","HAUTS-DE-France","AISNE",202812175,"Musée d'Art et d'Archéologie",NA,"Rue des Moulins","02250","Marle","France","fr","open",49.7417279,3.77142327619849,1430,4420,5850,1651,2676,4327,1285,3175,4460,1180,4024,5204,1187,4311,5498,1460,4204,5664
"196","2429901","0553812355","www.museevoulgre.cjb.net","NOUVELLE-AQUITAINE","DORDOGNE",3136128949,"Musée des Arts et Traditions Populaires du Périgord","1","Rue Raoul Grassin","24400","Mussidan","France","fr","open",45.0375278,0.362942,1246,1552,2798,823,1260,2083,942,1212,2154,808,1212,2020,891,1057,1948,1001,1389,2390
"197","4715701","0553644204","Site des musées aquitains et site de la ville","NOUVELLE-AQUITAINE","LOT ET GARONNE",155714123,"Musée Municipal Albert Marzelles",NA,"Rue Abel Boyé","47200","Marmande","France","fr","open",44.4988715,0.166028908783001,0,4128,4128,0,6516,6516,0,5866,5866,0,4467,4467,0,5571,5571,0,4933,4933
"198","7510602","0144418650","www.musee-delacroix.fr","ÎLE-DE-France","PARIS",395785603,"Musée National Eugène Delacroix",NA,"Rue Jacob","75006","Paris","France","fr","open",48.85464155,2.33539367059289,44311,35988,80299,40262,35336,75598,28362,29786,58148,28602,22694,51296,42085,26331,68416,42756,21652,64408
"199","6748202","0388525000","www.musees.strasbourg.eu","GRAND EST","BAS-RHIN",239825772,"Musée Archéologique",NA,"Rue du Bain-aux-Roses","67065","Strasbourg","France","fr","open",48.5808521,7.7525857,26663,30681,57344,23685,29700,53385,19361,27291,46652,19154,28662,47816,18845,31711,50556,17100,26879,43979
"200","2904601","0298926520","www.port-musee.org","BRETAGNE","FINISTERE",40686013,"Le Port-Musée",NA,"Place de l'Enfer","29100","Ploaré","France","fr","open",48.092424,-4.33259672340426,31134,10405,41539,39792,5933,45725,31375,21411,52786,37035,8059,45094,35477,4001,39478,30090,11509,41599
"201","3306303","0556102056","www.musba-bordeaux.fr","NOUVELLE-AQUITAINE","GIRONDE",79979299,"Musée des Beaux-Arts",NA,"Rue Dufau","33000","Bordeaux","France","fr","open",44.8373406,-0.580681712019891,36080,50891,86971,50023,62084,112107,51550,57224,108774,111625,0,111625,117492,0,117492,8743,51923,60666
"202","4923401","0241822880","www.musee-julesdesbois.fr ou www.damm49.fr","PAYS DE LA LOIRE","MAINE-ET-LOIRE",238336580,"Musée Jules-Desbois",NA,"Place Jules Desbois","49390","Parçay-les-Pins","France","fr","open",47.4364575,0.160016289399923,3396,1015,4411,2831,1491,4322,3597,860,4457,2246,2035,4281,2903,1891,4794,3492,2292,5784
"203","7226901","0243356303","www.saint-calais.fr","PAYS DE LA LOIRE","SARTHE",7856651558,"Bibliothèque-musée",NA,"Rue de la République","80000","Amiens","France","fr","open",49.8902852,2.2958703,89,1095,1184,0,3506,3506,0,3140,3140,0,5333,5333,0,3053,3053,0,2792,2792
"204","5014701","0233070788","www.ville-coutances.fr/musee.php","NORMANDIE","MANCHE",68664267,"Musée Quesnel-Morinière","2","Rue Quesnel-Morinière","50200","Coutances","France","fr","open",49.0472298,-1.4467416238048,5990,0,5990,6161,0,6161,392,7895,8287,366,6173,6539,244,5782,6026,208,5265,5473
"205","1305503","0491553360","www.marseille.fr/siteculture/les-lieux-culturels/musees/musee-borely","PROVENCE-ALPES-CÔTE D'AZUR","BOUCHES DU RHONE",2365711963,"Musée des Arts décoratifs, de la Faïence et de la Mode",NA,"Avenue Clot Bey","13008","Marseille","France","fr","open",43.2572605,5.3820342,10405,22127,32532,9676,21273,30949,20164,8598,28762,15032,25576,40608,19652,21745,41397,30458,16582,47040
"206","3800601","0476451640","https://museedallevard.wordpress.com/","AUVERGNE-RHÔNE-ALPES","ISERE",291316822,"Musée Jadis Allevard",NA,"Musée Jadis Allevard","38580","Allevard","France","fr","open",45.3924546,6.0758962,1485,1119,2604,4353,69,4422,1532,1787,3319,741,4039,4780,2859,3051,5910,5569,0,5569
"207","1451201","0231696254","www.condeintercom.fr","NORMANDIE","CALVADOS",7579732101,"Musée du Château",NA,"Rue des Léopards","14110","Vire","France","fr","open",48.8589438,-0.5682422,2859,2705,5564,3092,1798,4890,3125,1340,4465,3004,1621,4625,3076,1032,4108,3061,1337,4398
"208","1411803","0231304327","http://cpievdo.fr/cpie-presentation-environnement/musee-d-initiation-a-la-nature - site de la région","NORMANDIE","CALVADOS",6041330527,"Musée d'Initiation à la Nature",NA,"Rue du Carel","14000","Caen","France","fr","open",49.1801396,-0.3735491,0,5950,5950,0,4764,4764,0,6614,6614,0,5225,5225,0,6014,6014,0,7297,7297
"209","7127201","0385352202","www.saoneetloire71.fr","BOURGOGNE-FRANCHE-COMTE","SAONE ET LOIRE",6575800688,"Musée Départemental du Compagnonnage",NA,"Rue Pierre François Guillon","71570","Romanèche-Thorins","France","fr","open",46.1880514,4.733891,1895,2121,4016,2021,2412,4433,1835,2378,4213,2060,2119,4179,2200,2204,4404,2137,1635,3772
"210","9122301","0169926912","site de la ville","ÎLE-DE-France","ESSONNE",3407370497,"Musée Intercommunal d'Etampes",NA,"Chemin du Fourneou","91590","Cerny","France","fr","open",48.4959939,2.343302,643,9482,10125,289,5773,6062,872,6751,7623,684,5640,6324,667,5827,6494,616,6062,6678
"211","9408101","0143916420","www.macval.fr","ÎLE-DE-France","VAL DE MARNE",1938023794,"MAC VAL, Musée d'Art Contemporain du Val-de-Marne",NA,"Avenue du Moulin de Saquet","94400","Vitry-sur-Seine","France","fr","open",48.7920535,2.3852432,6802,53960,60762,8209,60758,68967,8752,59631,68383,9066,61240,70306,8237,58425,66662,8384,58854,67238
"212","8400702","0490864458","www.petit-palais.org","PROVENCE-ALPES-CÔTE D'AZUR","VAUCLUSE",309712990,"Musée du Petit Palais",NA,"Rue Ferruce","84000","Avignon","France","fr","open",43.9527473,4.8063438,2708,32403,35111,15124,16579,31703,13691,15567,29258,14075,12782,26857,15257,12873,28130,14359,10724,25083
"213","8838301","0329625914","www.remiremont.fr/culture/musees.php","GRAND EST","VOSGES",5390940587,"Musée Charles de Bruyères",NA,"Rue Charles de Gaulle","88200","Remiremont","France","fr","open",48.0161212,6.593241,445,1399,1844,469,1660,2129,427,1898,2325,430,2874,3304,609,2991,3600,429,2947,3376
"214","7110602","0385242474","Site des musées de Bourgogne ou site de la ville - http://www.ville-charolles.fr/musee-du-prieure","BOURGOGNE-FRANCHE-COMTE","SAONE ET LOIRE",2239784876,"Musée du Prieuré de Charolles","4","Rue du Prieuré","71120","Charolles","France","fr","open",46.4323423,4.2799145,1343,1616,2959,1064,1437,2501,872,1248,2120,1265,1602,2867,1456,1611,3067,1148,1260,2408
"215","5432901","0383760475","http://www.chateauluneville.meurthe-et-moselle.fr/","GRAND EST","MEURTHE ET MOSELLE",230083957,"Musée du Château de Lunéville",NA,"Avenue René Veillon","54480","Val-et-Châtillon","France","fr","open",48.5633965,6.96389696175373,37242,114559,151801,26333,152679,179012,28610,146234,174844,92397,60259,152656,0,150188,150188,9557,132745,142302
"216","0615501","0493647183","http://www.vallauris-golfe-juan.fr/","PROVENCE-ALPES-CÔTE D'AZUR","ALPES-MARITIMES",88040667,"Musée Magnelli, Musée de la Céramique",NA,"Place de la Libération","06220","Vallauris","France","fr","open",43.580016,7.0532145,17269,8099,25368,13226,10780,24006,0,0,0,0,0,0,0,0,0,0,0,0
"217","1300103","0442230991","www.aixenprovence.fr/Musee-des-Tapisseries","PROVENCE-ALPES-CÔTE D'AZUR","BOUCHES DU RHONE",34505703,"Musée des Tapisseries",NA,"Rue Cardinale","13626","Aix-en-Provence","France","fr","open",43.5254678,5.4526102,3243,11728,14971,2687,15449,18136,3499,13869,17368,3299,14322,17621,4638,14688,19326,4825,15731,20556
"218","0408801","0492709119","www.ville-forcalquier.fr/service-culturel.html","PROVENCE-ALPES-CÔTE D'AZUR","ALPES DE HAUTE PROVENCE",5921065703,"Musée Municipal",NA,"D 13","04300","Mane","France","fr","open",43.9352027,5.7592489,0,1280,1280,0,1997,1997,0,1399,1399,0,600,600,0,972,972,0,700,700
"219","6938101","0472691717","www.mac-lyon.com","AUVERGNE-RHÔNE-ALPES","RHÔNE",62277312,"Musée d'Art Contemporain de Lyon",NA,"Allée Achille Lignon","69006","Lyon","France","fr","open",45.7842186,4.85246974608295,37451,34861,72312,36707,75189,111896,59265,75735,135000,54505,77015,131520,39212,45853,85065,147030,0,147030
"220","6822401","0389337811","http://www.musees.mulhouse.museum/dn_beaux_arts/","GRAND EST","HAUT-RHIN",343385574,"Musée des Beaux-Arts",NA,"Rue Guillaume Tell","68100","Mulhouse","France","fr","open",47.7457898,7.3384212,0,19341,19341,0,7284,7284,0,14664,14664,0,18527,18527,0,19548,19548,0,18405,18405
"221","4024601","0558083131","www.marqueze.fr","NOUVELLE-AQUITAINE","LANDES",253999961,"Ecomusée de la Grande Lande",NA,"Route de la Gare","40630","Sabres","France","fr","open",44.14936935,-0.746856171420411,73617,14121,87738,85988,17210,103198,74725,16369,91094,70914,17076,87990,68470,14321,82791,58741,12197,70938
"222","3414201","0467888610","www.museedelodeve.fr","OCCITANIE","HERAULT",5835417743,"Musée de Lodève - Hôtel du cardinal de Fleury",NA,"Rue du Cardinal Fleury","34700","Lodève","France","fr","open",43.7318449,3.31993,24121,5166,29287,11956,5605,17561,8901,2592,11493,11658,4968,16626,34395,10842,45237,21997,7664,29661
"223","8400701","0490824351","www.museum-avignon.org - http://www.museum-requien.org/","PROVENCE-ALPES-CÔTE D'AZUR","VAUCLUSE",83784740,"Muséum d'Histoire Naturelle Esprit Requien","27","Rue de la République","84000","Avignon","France","fr","open",43.9458915,4.80602621868935,0,16705,16705,0,15055,15055,0,14840,14840,0,16351,16351,0,15394,15394,0,13206,13206
"224","6748208","0388525001","www.musees-strasbourg.eu","GRAND EST","BAS-RHIN",239813123,"Musée Alsacien","23","Quai Saint-Nicolas","67065","Strasbourg","France","fr","open",48.5791319,7.7506043,38258,27531,65789,35069,28845,63914,35165,27531,62696,35629,24771,60400,37249,26111,63360,30492,31869,62361
"225","0920701","0534093060","www.sesta.fr","OCCITANIE","ARIEGE",3241536133,"Musée de la Forge",NA,"Rue du Rocher","09000","Foix","France","fr","open",42.9657002,1.6047597,32870,0,32870,31123,0,31123,28402,0,28402,27732,0,27732,30659,0,30659,31848,0,31848
"226","3403901","0467783357","www.bouzigues.fr/musee","OCCITANIE","HERAULT",277812836,"Musée de l'Etang de Thau",NA,"Chemin du Belvédère","34140","Bouzigues","France","fr","open",43.446872,3.6617685,3110,8860,11970,11277,2153,13430,12666,1576,14242,12772,1964,14736,12992,1756,14748,14489,1904,16393
"227","5314701","0243001717","www.museeduchateaudemayenne.fr","PAYS DE LA LOIRE","MAYENNE",1934021701,"Musée du Château de Mayenne",NA,"Quai Carnot","53100","Mayenne","France","fr","open",48.3028395,-0.6179027,7852,12769,20621,10980,10651,21631,7899,9274,17173,10283,9834,20117,11137,7796,18933,10700,12332,23032
"228","3601801","0254372520","Site de la région centre","CENTRE-VAL DE LOIRE","INDRE",214892,"Musée Ornithologique (Ecomusée de la Brenne)",NA,"Cour du Cheval Blanc","77300","Fontainebleau","France","fr","open",48.4023346,2.70053873669076,1846,1547,3393,1353,941,2294,2190,1576,3766,1993,2125,4118,1533,1442,2975,1529,708,2237
"229","5771201","0387780530","www.cg57.fr/culture/1-8-delatour.asp","GRAND EST","MOSELLE",227335819,"Musée Départemental Georges de la Tour",NA,"Place Jeanne D'Arc","57630","Vic-sur-Seille","France","fr","open",48.781924,6.53100291713571,3809,3367,7176,3637,2284,5921,2684,3447,6131,5451,4530,9981,3758,6614,10372,8259,11772,20031
"230","6276701","0321045625","Site de la ville www.ville-saintpolsurternoise.fr/","HAUTS-DE-France","PAS-DE-CALAIS",204398267,"Musée Municipal Bruno Danvin",NA,"Rue Oscar Ricque","62130","Saint-Pol-sur-Ternoise","France","fr","open",50.381508,2.3372638,0,3415,3415,0,3499,3499,0,4144,4144,0,5127,5127,0,4350,4350,0,5194,5194
"231","7855101","0139078787","www.musee-mauricedenis.fr","ÎLE-DE-France","YVELINES",154883691,"Musée Départemental Maurice Denis","2bis","Rue Maurice Denis","78100","Saint-Germain-en-Laye","France","fr","open",48.8925939,2.08688899191639,8432,3164,11596,13047,5301,18348,10976,5189,16165,20736,0,20736,6091,20652,26743,6228,22127,28355
"232","1729904","0546998657","www.musee-marine.fr/rochefort","NOUVELLE-AQUITAINE","CHARENTE-MARITIME",90808269,"Musée National de la Marine",NA,"Rue Amiral Meyer","17300","Rochefort","France","fr","open",45.9423,-0.964952785714284,18859,11293,30152,16134,11672,27806,12549,11444,23993,23497,22011,45508,18341,18329,36670,18786,19094,37880
"233","4900708","0241054850","www.angers.fr/museum","PAYS DE LA LOIRE","MAINE-ET-LOIRE",8142950,"Muséum des Sciences Naturelles","43","Rue Jules Guitton","49000","Angers","France","fr","open",47.473709,-0.546284064285715,5428,20811,26239,4547,19395,23942,3607,17432,21039,3898,18005,21903,3843,20589,24432,3639,13809,17448
"234","7645201","0235331351","www.musee-sapeurs-pompiers.org - www.mairie-montville.fr","NORMANDIE","SEINE-MARITIME",621958895,"Musée des Sapeurs-Pompiers de France",NA,"Rue Baron Bigot","76710","Montville","France","fr","open",49.5474655,1.07635013515406,5826,4038,9864,5699,4442,10141,5352,3874,9226,5750,4407,10157,5064,4306,9370,4717,5847,10564
"235","5012901","0233535161","Site de la ville - www.ville-cherbourg.fr","NORMANDIE","MANCHE",1932681880,"Muséum Emmanuel Liais",NA,"Rue de l'Abbaye","50100","Cherbourg-en-Cotentin","France","fr","open",49.6429877,-1.6294662,2215,6077,8292,2366,5827,8193,1842,7607,9449,0,13669,13669,0,12759,12759,0,13443,13443
"236","2541801","0381552977","www.maisons-comtoises.org","BOURGOGNE-FRANCHE-COMTE","DOUBS",33921375,"Musée de Plein Air des Maisons Comtoises",NA,"Rue du Musée","25360","Nancray","France","fr","open",47.23771675,6.18440842229026,30796,13127,43923,29524,11998,41522,31663,8994,40657,28020,15144,43164,32691,14117,46808,32397,12633,45030
"237","7156601","0385915709","www.verdunsurledoubs.fr rubrique culture ou www.ecomusee-de-la-bresse.com","BOURGOGNE-FRANCHE-COMTE","SAONE ET LOIRE",1840508168,"Maison du Blé et du Pain",NA,"Rue des Jardins","71350","Verdun-sur-le-Doubs","France","fr","open",46.8987867,5.0226253,2312,1433,3745,2334,1492,3826,2532,1474,4006,2069,1334,3403,2653,1850,4503,2297,1840,4137
"238","2123105","0380488200","www.dijon.fr","BOURGOGNE-FRANCHE-COMTE","CÔTE D’OR",255935624,"Muséum - Jardin des Sciences",NA,"Avenue Albert 1er","21000","Dijon","France","fr","open",47.3218523,5.0289424,14169,105374,119543,15283,107542,122825,13214,95944,109158,14393,107405,121798,6390,105318,111708,6574,104315,110889
"239","5618102","0297821913","http://musee.lorient.fr","BRETAGNE","MORBIHAN",2854735857,"Musée de la Compagnie des Indes",NA,"Grand pont","56290","Port-Louis","France","fr","open",47.7106223,-3.3637818,38691,32753,71444,37107,32694,69801,37585,27921,65506,39756,30292,70048,37898,29049,66947,33839,29209,63048
"240","2B09601","0495452545","www.musee-corse.com","CORSE","HAUTE-CORSE",6234663071,"Musée de la Corse",NA,"Place du Poilu","20250","Corte","France","fr","open",42.3058166,9.1484352,63250,9726,72976,59986,14300,74286,56456,10285,66741,58601,9958,68559,61761,10950,72711,60033,11492,71525
"241","6743701","0388716395","http://www.louise weiss.org","GRAND EST","BAS-RHIN",1801327289,"Musée du Château des Rohan",NA,"Place du Général de Gaulle","67700","Saverne","France","fr","open",48.7418466,7.3639083,3968,3678,7646,4055,4231,8286,3501,3963,7464,3535,3870,7405,4327,4156,8483,4130,3574,7704
"242","7733301","0164785480","www.musee-prehistoire-idf.fr","ÎLE-DE-France","SEINE ET MARNE",2177750355,"Musée Départemental de Préhistoire d'Île de France",NA,"Cours du Château","77140","Nemours","France","fr","open",48.2655865,2.6970907,1409,8143,9552,4972,23131,28103,3931,22953,26884,5498,22009,27507,4144,24154,28298,6607,27646,34253
"243","7511502","0149547373","www.bourdelle.paris.fr","ÎLE-DE-France","PARIS",1212876,"Musée Bourdelle","16","Rue Antoine Bourdelle","75015","Paris","France","fr","open",48.843215,2.31866323681787,18500,39322,57822,97436,20000,117436,2720,36657,39377,16743,25849,42592,6124,23942,30066,12433,54170,66603
"244","2718301","0232362880","http://www.lacoutureboussey.com/default.asp?file=pg25-1_fr","NORMANDIE","EURE",581537349,"Musée Artisanal et Industriel d'Instruments à Vent",NA,"D 833","27750","La Couture-Boussey","France","fr","open",48.8975422,1.40773390685044,0,2781,2781,0,3449,3449,1965,1303,3268,2482,1236,3718,2500,902,3402,2988,924,3912
"245","7654003","0235155995","http://www.rouen.fr/medecine ou http://www3.chu-rouen.fr/Internet/connaitreCHU/culture/musee_flaubert","NORMANDIE","SEINE-MARITIME",64181527,"Musée Flaubert et d'Histoire de la Médecine",NA,"Esplanade Marcel Duchamp","76000","Rouen","France","fr","open",49.44473675,1.09458188041562,2747,4618,7365,2702,4820,7522,2775,4260,7035,2849,4855,7704,3888,4096,7984,4318,3055,7373
"246","0616301","0493043250","www.museedesmerveilles.com","PROVENCE-ALPES-CÔTE D'AZUR","ALPES-MARITIMES",769232481,"Musée Départemental des Merveilles",NA,"Avenue du 16 Septembre 1947","06430","Tende","France","fr","open",44.0902585,7.5923772,0,23012,23012,0,24987,24987,4249,23220,27469,1675,27077,28752,6438,20281,26719,1207,34343,35550
"247","1501401","0471480700","www.aurillac.fr","AUVERGNE-RHÔNE-ALPES","CANTAL",2085157238,"Musée des Sciences",NA,"Rue des Fourmillères","15120","Lacapelle-del-Fraisse","France","fr","open",44.7599649,2.4617902,3224,6611,9835,3326,6441,9767,2685,7993,10678,2901,6549,9450,4609,4891,9500,949,9711,10660
"248","2123103","0380671110","www.musee-magnin.fr","BOURGOGNE-FRANCHE-COMTE","CÔTE D’OR",2751550494,"Musée Magnin",NA,"Rue des Bons Enfants","21000","Dijon","France","fr","open",47.3209486,5.0422275,7155,10737,17892,6270,9736,16006,7459,10629,18088,6798,10314,17112,4816,9294,14110,5165,7768,12933
"249","3724201","0247580905","www.ecomusee-veron.fr","CENTRE-VAL DE LOIRE","INDRE ET LOIRE",207799176,"Ecomusée du Véron","80","Route de Candes","37420","Savigny-en-Véron","France","fr","open",47.20943595,0.12443469830615,3608,5109,8717,4996,2563,7559,7365,3587,10952,2479,2228,4707,0,2125,2125,8472,0,8472
"250","7634101","0235454062","site de la région","NORMANDIE","SEINE-MARITIME",125522834,"Musée du Prieuré",NA,"Rue du Prieuré","76700","Harfleur","France","fr","open",49.5074236,0.201473083700349,182,1990,2172,150,2000,2150,158,2082,2240,181,599,780,112,4186,4298,118,4105,4223
"251","6015901","0344384700","www.musee-chateau-compiegne.fr - http://palaisdecompiegne.fr/","HAUTS-DE-France","OISE",1789074264,"Musée du Château de Compiègne",NA,"Place du Général de Gaulle","60200","Compiègne","France","fr","open",49.4188454,2.830196,32004,54444,86448,54130,34468,88598,37011,49340,86351,31522,44392,75914,36823,45449,82272,34519,45340,79859
"252","1730006","0546411825","www.museum-larochelle.fr/","NOUVELLE-AQUITAINE","CHARENTE-MARITIME",119814128,"Muséum d'Histoire Naturelle",NA,"Rue Albert 1er","17000","La Rochelle","France","fr","open",46.164811,-1.15114459699104,17704,45353,63057,13179,41732,54911,10508,40133,50641,13998,38528,52526,10116,34856,44972,9262,29578,38840
"253","1126202","0468903054","www.mairie-narbonne.fr","OCCITANIE","AUDE",92058703,"Musée Archéologique",NA,"Rue des Jacobins","11100","Narbonne","France","fr","open",43.1809595,3.00414725520834,0,0,0,0,0,0,0,0,0,0,0,0,0,0,0,0,0,0
"254","3933301","0384423864","www.musee-du-jouet.com","BOURGOGNE-FRANCHE-COMTE","JURA",201412221,"Musée du Jouet","5","Rue du Murgin","39260","Moirans-en-Montagne","France","fr","open",46.4325233,5.72701294070762,39240,12208,51448,34412,10658,45070,37811,9516,47327,37034,10169,47203,47105,18976,66081,34391,8662,43053
"255","5145404","0326353690","www.reims.fr/musee-saint-remi","GRAND EST","MARNE",1347407,"Musée Saint-Rémi",NA,"Rue Simon","51100","Reims","France","fr","open",49.243337,4.04039219949564,8309,15432,23741,7744,13072,20816,4692,14270,18962,4330,19229,23559,4369,29071,33440,4908,16854,21762
"256","6061203","0344294993","Site de la ville","HAUTS-DE-France","OISE",5357724995,"Musée de la Vénerie",NA,"Place Saint-Maurice","60300","Senlis","France","fr","open",49.2072693,2.5833865,1303,3355,4658,2145,3294,5439,1483,4754,6237,2411,3955,6366,2573,3830,6403,1691,3001,4692
"257","5056201","0233543333","http://tatihou.manche.fr","NORMANDIE","MANCHE",39578602,"Musée Maritime de l'Ile de Tatihou",NA,"Le Run","50550",NA,"France","fr","open",49.59021435,-1.24675178300586,68351,3213,71564,66109,3192,69301,49148,3925,53073,58035,4410,62445,58490,4457,62947,58859,5118,63977
"258","7654006","0235884292","http://museelesecqdestournelles.fr","NORMANDIE","SEINE-MARITIME",64181345,"Musée Le Secq des Tournelles","2","Rue Jacques Villon","76000","Rouen","France","fr","open",49.4444344,1.09529468373377,90830,0,90830,14055,15010,29065,1674,17351,19025,3958,5794,9752,4182,7385,11567,4902,7315,12217
"259","5808601","0386267102","http://www.museedelaloire.fr","BOURGOGNE-FRANCHE-COMTE","NIÈVRE",153863024,"Musée de la Loire",NA,"Place de la Résistance","58200","Cosne-Cours-sur-Loire","France","fr","open",47.410323,2.92343000294118,2364,2609,4973,3934,1496,5430,1188,4415,5603,948,5434,6382,1247,3989,5236,1182,3185,4367
"260","7135101","0385762716","www.ecomusee-de-la-bresse.com","BOURGOGNE-FRANCHE-COMTE","SAONE ET LOIRE",3617522815,"Ecomusée de la Bresse Bourguignonne",NA,"Rue du Château","71270","Pierre-de-Bresse","France","fr","open",46.8828547,5.2614005,22620,18476,41096,23845,17142,40987,24665,13508,38173,26262,15427,41689,26033,15560,41593,25249,17980,43229
"261","5830401","0386297203","www.cg58.fr ou www.musees-bourgogne.org","BOURGOGNE-FRANCHE-COMTE","NIÈVRE",1356183136,"Musée Auguste Grasset",NA,"Rue de la Caserne","58210","Varzy","France","fr","open",47.3586963,3.3887096,1050,200,1250,1291,400,1691,1794,0,1794,1903,0,1903,2400,0,2400,2288,0,2288
"262","2505607","0381878305","www.citadelle.com","BOURGOGNE-FRANCHE-COMTE","DOUBS",7345774337,"Muséum de Besançon",NA,"Chemin de Ronde de la Citadelle","25000","Besançon","France","fr","open",47.2285217,6.034794,187034,0,187034,104632,95187,199819,236458,33606,270064,222148,0,222148,299168,0,299168,240320,28107,268427
"263","3818505","0476634444","www.museedegrenoble.fr","AUVERGNE-RHÔNE-ALPES","ISERE",5107373,"Musée de Grenoble",NA,"Voie de Corato","38000","Grenoble","France","fr","open",45.1949735,5.73225303570658,77021,128092,205113,69698,115248,184946,93678,116590,210268,65524,102167,167691,36266,94149,130415,94540,101467,196007
"264","5753701","0387870854","www.musee-les-mineurs.fr","GRAND EST","MOSELLE",823312790,"Musée de la Mine - Carreau Wendel",NA,"Rue Saint-Charles","57540","Petite-Rosselle","France","fr","open",49.2039277,6.8630557,34315,12000,46315,57042,5600,62642,41608,4456,46064,42949,26140,69089,41228,7029,48257,32522,11178,43700
"265","4932802","0241402440","www.chateau-saumur.com","PAYS DE LA LOIRE","MAINE-ET-LOIRE",6288432418,"Château-Musée",NA,"Passage du Marquis de Geoffre","49730","Montsoreau","France","fr","open",47.2156815,0.0624464,78477,15549,94026,79766,14581,94347,72104,12595,84699,68373,13266,81639,68782,13548,82330,77110,19659,96769
"266","8413701","0490365005","Site de la ville - www.vaison-la-romaine.com","PROVENCE-ALPES-CÔTE D'AZUR","VAUCLUSE",88549191,"Musée Archéologique Théo Desplans",NA,"Rue Burrus","84110","Vaison-la-Romaine","France","fr","open",44.2428537,5.07463072267492,59378,9957,69335,57924,10320,68244,62574,13580,76154,63330,14380,77710,66615,16047,82662,60053,14307,74360
"267","7401001","0450338730","http://musees.agglo-annecy.fr/Chateau-d-Annecy","AUVERGNE-RHÔNE-ALPES","HAUTE-SAVOIE",4891589833,"Musée-château d'Annecy",NA,"Rampe du Château","74000","Annecy","France","fr","open",45.8976583,6.1260527,73141,67369,140510,107615,20243,127858,65545,56704,122249,50406,63011,113417,80009,31675,111684,44430,53541,97971
"268","0732401","0475081030","www.chateaumusee-tournon.com","AUVERGNE-RHÔNE-ALPES","ARDECHE",2793855499,"Musée du Rhône",NA,NA,"07270","Lamastre","France","fr","open",44.9980175,4.6108622,17378,11134,28512,13248,16404,29652,14892,11091,25983,12537,17268,29805,17131,15436,32567,10606,8987,19593
"269","0209301","0323391471","www.museefrancoamericain.fr","HAUTS-DE-France","AISNE",3724972649,"Musée Franco-Américain du Château de Blérancourt",NA,"Place du Général Leclerc","02300","Blérancourt","France","fr","open",49.5176668,3.1530757,5849,6442,12291,4237,5041,9278,246,501,747,186,1389,1575,686,813,1499,179,620,799
"270","1925101","0555217777","www.museepresidentjchirac.fr","NOUVELLE-AQUITAINE","CORREZE",950074172,"Musée du Président Jacques Chirac",NA,"Route du Musée","19800","Sarran","France","fr","open",45.4079599,1.9398374,11649,3479,15128,15988,5472,21460,14801,4601,19402,15967,4184,20151,17301,4931,22232,25413,6609,32022
"271","0121801","0479875223","www.musees.ain.fr","AUVERGNE-RHÔNE-ALPES","AIN",210386723,"Musée du Bugey-Valmorey",NA,"Impasse de la Forge","01260","Belley","France","fr","open",45.9296855,5.72669272933142,2880,2520,5400,2356,2172,4528,2413,2377,4790,2449,2344,4793,2869,2007,4876,2609,2808,5417
"272","1819701","0248965520","www.ville-saint-amand-montrond.fr","CENTRE-VAL DE LOIRE","CHER",2126258013,"Musée Saint-Vic",NA,"Cours Manuel","18200","Saint-Amand-Montrond","France","fr","open",46.7214136,2.507645,0,4792,4792,0,4791,4791,0,4347,4347,0,5238,5238,0,4367,4367,0,3398,3398
"273","5430001","0383531696","http://www.nancy.fr/transver/coord.htm#muslor - Site du Grand Nancy","GRAND EST","MEURTHE ET MOSELLE",99542401,"Musée du Château de Montaigu",NA,"Avenue Général de Gaulle","54140","Jarville-la-Malgrange","France","fr","open",48.6665075,6.20871347159091,634,1256,1890,454,400,854,0,0,0,0,0,0,0,0,0,0,0,0
"274","9405201","0148755125","www.musee-nogentsurmarne.fr","ÎLE-DE-France","VAL DE MARNE",1788374144,"Musée de Nogent-Sur-Marne","36","Boulevard Gallieni","94130","Nogent-sur-Marne","France","fr","open",48.840397,2.4849183,491,6566,7057,467,5907,6374,498,6108,6606,0,4902,4902,0,7126,7126,512,5604,6116
"275","5021801","0233510294","www.ville-granville.fr","NORMANDIE","MANCHE",5864155897,"Musée Richard Anacréon",NA,"Rue Notre-Dame","50400","Granville","France","fr","open",48.8385103,-1.6006345,6711,7250,13961,7755,6944,14699,7375,6079,13454,5844,6810,12654,7900,8526,16426,9796,6613,16409
"276","1700401","0546846640","http://musees-nationaux-malmaison.fr/musees-napoleonien-africain/","NOUVELLE-AQUITAINE","CHARENTE-MARITIME",64991060,"Musée Napoléonien et Africain",NA,"Rue des Remparts","17123","Île-d'Aix","France","fr","open",46.01301115,-1.17465635827834,13070,10594,23664,11549,10117,21666,10843,9161,20004,11447,10125,21572,10259,9275,19534,11319,10556,21875
"277","1220202","0565778960","http://musee-denys-puech.grand-rodez.com/","OCCITANIE","AVEYRON",124625419,"Musée des Beaux-Arts Denys Puech",NA,"Place Clemenceau","12000","Rodez","France","fr","open",44.3488905,2.57832657757143,0,11755,11755,0,8086,8086,0,7963,7963,0,12331,12331,0,10750,10750,2273,8154,10427
"278","6620501","0468290776","www.450000ans.com ou www.cerptautavel.com","OCCITANIE","PYRENEES ORIENTALES",188829574,"Musée de Tautavel",NA,"Avenue Louis Baixas","66720","Tautavel","France","fr","open",42.815132,2.75017670686312,44548,8500,53048,49273,8793,58066,52959,11891,64850,58945,11074,70019,54680,9714,64394,56568,9101,65669
"279","4418401","0251101206","www.leportdetouslesvoyages.com ou www.saint-nazaire-tourisme.com","PAYS DE LA LOIRE","LOIRE-ATLANTIQUE",182415,"Ecomusée de Saint-Nazaire",NA,NA,"44600","Saint-Nazaire","France","fr","open",47.2733517,-2.2138905,38043,8795,46838,36929,11876,48805,29086,9587,38673,34726,8704,43430,31631,17862,49493,28139,14912,43051
"280","0608813","0493626162","www.mamac-nice.org","PROVENCE-ALPES-CÔTE D'AZUR","ALPES-MARITIMES",1949582,"Musée d'Art Moderne et d'Art Contemporain",NA,"Place Yves Klein","06300","Nice","France","fr","open",43.701442,7.27822756843373,48932,83836,132768,67713,72547,140260,64612,91129,155741,38533,47802,86335,0,158714,158714,24953,134242,159195
"281","2A00402","0495214389","https://musees-nationaux-malmaison.fr","CORSE","CORSE DU SUD",2627082116,"Musée de la Maison Bonaparte",NA,"Rue Saint-Charles","20000","Ajaccio","France","fr","open",41.9179847,8.7385137,59664,29410,89074,57427,28680,86107,59913,29642,89555,46750,23808,70558,42905,24666,67571,43690,24224,67914
"282","6216001","0321100220","http://musee.ville-boulogne-sur-mer.fr","HAUTS-DE-France","PAS-DE-CALAIS",1022553,"Musée de Boulogne-sur-Mer",NA,"Rue de Bernet","62200","Boulogne-sur-Mer","France","fr","open",50.72565845,1.61773486770973,13931,19595,33526,14452,14247,28699,12668,19130,31798,12076,11461,23537,16257,13827,30084,14933,11582,26515
"283","6249801",NA,"www.louvrelens.fr","HAUTS-DE-France","PAS-DE-CALAIS",164827232,"Louvre-Lens (collections nationales decentralisées)",NA,"Rue Paul Bert","62300","Lens","France","fr","open",50.430517,2.80629404126984,71544,411215,482759,124985,325339,450324,124489,320113,444602,141504,212257,353761,196754,295130,491884,166744,696373,863117
"284","1518701","0471602232","www.auvergne-centrefrance.com/geotouring/musees/detail/mus154.htm","AUVERGNE-RHÔNE-ALPES","CANTAL",982070993,"Musée de la Haute Auvergne",NA,"Place d'Armes","15100","Saint-Flour","France","fr","open",45.0330738,3.0948739,2573,5620,8193,1874,4932,6806,1700,3564,5264,1891,3223,5114,1618,5264,6882,2104,3264,5368
"285","7104001","0385682285","www.ecomusee-creusot-montceau.fr Site des musées de Bourgogne et de l'écomusée","BOURGOGNE-FRANCHE-COMTE","SAONE ET LOIRE",153902869,"Musée de la Mine",NA,"Rue du Bois Clair","71450","Blanzy","France","fr","open",46.701234,4.3823826407563,10257,1953,12210,9452,1168,10620,9286,1902,11188,9339,1173,10512,9468,1106,10574,9663,1953,11616
"286","7024501","0384495250","www.ecomusee-fougerolles.fr","BOURGOGNE-FRANCHE-COMTE","HAUTE-SAONE",192995465,"Ecomusée du Pays de la Cerise",NA,"Le Petit Fahys","70220","Lure","France","fr","open",47.90680895,6.40233578095083,6182,4150,10332,6281,2624,8905,6116,2048,8164,7124,2134,9258,7471,2179,9650,7378,2672,10050
"287","2105401","0380220819","www.musees-bourgogne.org ou www.beaune.fr","BOURGOGNE-FRANCHE-COMTE","CÔTE D’OR",365168495,"Musée du Vin de Bourgogne",NA,"Rue Paradis","21200","Beaune","France","fr","open",47.0235691,4.837196,20487,4597,25084,11426,3884,15310,10355,3542,13897,13167,3600,16767,15776,3691,19467,17469,4126,21595
"288","6806601","0389201550","www.musee-unterlinden.com","GRAND EST","HAUT-RHIN",1265125753,"Musée d'Unterlinden",NA,"Place Unterlinden","68000","Colmar","France","fr","open",48.0798635,7.3555565,161223,35391,196614,173530,40000,213530,222852,71148,294000,129744,29767,159511,154080,30679,184759,127745,23133,150878
"289","7737901","0164005960","Site de la ville : www.mairie-provins.fr","ÎLE-DE-France","SEINE ET MARNE",2281215620,"Musée de Provins et du Provinois",NA,"Rue du Palais","77160","Provins","France","fr","open",48.5615816,3.2907221,13417,6127,19544,16340,4985,21325,16541,3314,19855,18132,3732,21864,15709,5206,20915,15640,5578,21218
"290","6618101","0468040805","www.museedecerdagne.com","OCCITANIE","PYRENEES ORIENTALES",1874518307,"Musée de Cerdagne",NA,"Impasse de la Vigne","66800","Sainte-Léocadie","France","fr","open",42.4364819,2.0026983,2896,947,3843,3387,723,4110,2640,920,3560,3741,1012,4753,2636,1327,3963,4162,662,4824
"291","6613601","0468515046","Site de la mairie - www.mairie-perpignan.fr","OCCITANIE","PYRENEES ORIENTALES",1227556,"Musée du Castillet Casa Pairal",NA,"Rue de l'Ange","66000","Perpignan","France","fr","open",42.6979518,2.89338790106175,11333,16998,28331,17518,18122,35640,14619,14049,28668,11907,12099,24006,8381,10005,18386,8497,10941,19438
"292","8413901","0490203720","www.vaucluse.fr/pages/page/num/519/lan/1","PROVENCE-ALPES-CÔTE D'AZUR","VAUCLUSE",694831616,"Musée-Bibliothèque François Pétrarque",NA,"Chemin de la Fontaine de Vaucluse","84800","Fontaine-de-Vaucluse","France","fr","open",43.9220356,5.1302755,1566,1800,3366,1342,2091,3433,1359,759,2118,1949,862,2811,2146,1022,3168,2095,1535,3630
"293","2923202","0298952160","www.cg29.fr/culture/mdb.htm - Site en cours","BRETAGNE","FINISTERE",94312010,"Musée Départemental Breton","1","Rue du Roi Gradlon","29000","Quimper","France","fr","open",47.9953725,-4.1025369543379,22271,23159,45430,19443,24289,43732,13086,14561,27647,17700,19286,36986,22749,23724,46473,16709,24030,40739
"294","3608801","0254210176","www.issoudun.fr","CENTRE-VAL DE LOIRE","INDRE",238746663,"Musée de l'Hospice Saint-Roch",NA,"Rue de l'Hospice Saint-Roch","36100","Issoudun","France","fr","open",46.944976,1.9942319952381,0,22327,22327,0,27033,27033,276,22544,22820,479,16649,17128,374,16282,16656,133,14278,14411
"295","8838302","0329625913","www.remiremont.fr/culture/musees.php","GRAND EST","VOSGES",2582715284,"Musée Charles Friry","12","Rue du Général Humbert","88200","Remiremont","France","fr","open",48.0151071,6.5897788,495,1145,1640,390,1616,2006,397,2077,2474,489,1983,2472,583,1262,1845,515,1883,2398
"296","7510301","0153019240","www.chassenature.org/","ÎLE-DE-France","PARIS",156973373,"Musée de la Chasse et de la Nature","62","Rue des Archives","75003","Paris","France","fr","open",48.86125555,2.35878269835448,56110,70929,127039,53196,65875,119071,30529,40042,70571,27254,30171,57425,22600,30762,53362,21003,29269,50272
"297","0608804","0493717833","Site de la ville : www.nice.fr/Culture/Musees-et-expositions/Musee-d-Art-Naif","PROVENCE-ALPES-CÔTE D'AZUR","ALPES-MARITIMES",708311359,"Musée d'Art Naïf Anatole Jakovsky",NA,"Avenue du Rond-Point","06206","Nice","France","fr","open",43.68595375,7.2326187359269,1824,5756,7580,2671,4841,7512,4284,4317,8601,9020,3054,12074,0,17548,17548,0,18162,18162
"298","8062002","0322831418","www.historial.org","HAUTS-DE-France","SOMME",193012404,"Musée-Historial de la Grande Guerre",NA,"Rue de la Résistance","80200","Péronne","France","fr","open",49.929138,2.93060001381109,118114,13347,131461,80774,8743,89517,93569,8247,101816,72076,8706,80782,90384,23275,113659,58894,16346,75240
"299","3155505","0561534825",NA,"OCCITANIE","HAUTE-GARONNE",63801451,"Musée Georges Labit","17","Rue du Japon","31400","Toulouse","France","fr","open",43.59109665,1.45845151911364,6292,23425,29717,5868,22740,28608,7334,17954,25288,6090,15346,21436,5800,11940,17740,5696,12102,17798
"300","6544001","0562361283","www.musee-massey.com","OCCITANIE","HAUTES-PYRENEES",122325318,"Musée Massey",NA,"Rue Achille Jubinal","65000","Tarbes","France","fr","open",43.239067,0.0752839918699174,5007,5901,10908,4661,5471,10132,4971,5763,10734,5388,6469,11857,4744,5674,10418,5853,7261,13114
"301","5439506","0383853072","www.mairie-nancy.fr - http://mban.nancy.fr/","GRAND EST","MEURTHE ET MOSELLE",753920204,"Musée des Beaux-Arts de Nancy",NA,"Rue Stanislas","54100","Nancy","France","fr","open",48.6936593,6.18189953876202,39963,68910,108873,55883,66894,122777,48924,67159,116083,54028,64504,118532,40684,60734,101418,41902,72114,114016
"302","7218102","0243473880","Site de la ville - www.ville-lemans.fr","PAYS DE LA LOIRE","SARTHE",2088806259,"Musée de la Reine Bérengère","7","Rue de la Reine Bérengère","72000","Le Mans","France","fr","open",48.0089768,0.1976955,2423,8872,11295,2334,8777,11111,1551,10322,11873,1615,8667,10282,2098,9916,12014,2316,6124,8440
"303","8212101","0563221385","www.museum.montauban.com/","OCCITANIE","TARN-ET-GARONNE",127805191,"Musée d'Histoire Naturelle Victor Brun",NA,"Rue Marie Lafon","82000","Montauban","France","fr","open",44.01688865,1.3514607739558,1589,7062,8651,1581,7724,9305,1619,8439,10058,1371,5518,6889,1421,5853,7274,1461,7312,8773
"304","0506101","0492510158","http://museum.hautes-alpes.fr ou site du conseil départemental","PROVENCE-ALPES-CÔTE D'AZUR","HAUTES-ALPES",1255767096,"Musée Départemental des Hautes-Alpes",NA,"Avenue du Maréchal Foch","05000","Gap","France","fr","open",44.5622653,6.0858366,0,19440,19440,0,18153,18153,0,17986,17986,0,16423,16423,0,19383,19383,0,10939,10939
"305","2505601","0381878067","www.mbaa.besancon.fr","BOURGOGNE-FRANCHE-COMTE","DOUBS",9493688,"Musée des Beaux-Arts et d'Archéologie",NA,"Place de la Révolution","25000","Besançon","France","fr","open",47.2402151,6.0235125688978,0,31215,31215,0,8930,8930,0,11252,11252,30214,16255,46469,1,16478,16479,12,44878,44890
"306","6822408","0389337810","www.musees-mulhouse.fr/musee-historique/collections.html","GRAND EST","HAUT-RHIN",2537131567,"Musée Historique",NA,"Place de la Réunion","68100","Mulhouse","France","fr","open",47.7465763,7.3392546,0,37006,37006,0,34144,34144,0,38899,38899,0,32426,32426,0,43380,43380,0,33469,33469
"307","6938502","0472384930","www.musees-gallo-romains.com","AUVERGNE-RHÔNE-ALPES","RHÔNE",88526510,"Lugdunum - Musée et Théâtres Romains",NA,"Rue Cléberg","69005","Lyon","France","fr","open",45.760301,4.82072944786325,42202,82820,125022,37483,72301,109784,27099,67377,94476,21094,58686,79780,22351,58411,80762,22089,54336,76425
"308","6806301","0389758880","www.musee-cernay.org","GRAND EST","HAUT-RHIN",6211249261,"Musée de la Porte de Thann",NA,"Rue Haffner","68700","Cernay","France","fr","open",47.8099726,7.1731847,40,111,151,38,113,151,167,338,505,225,141,366,400,148,548,228,68,296
"309","1038701","0325762168","www.musees-troyes.com","GRAND EST","AUBE",73123253,"Muséum d'Histoire Naturelle (Musée Pic Saint-Loup)","61","Rue de la Cité","10000","Troyes","France","fr","open",48.3007334,4.0804207078484,0,0,0,0,0,0,0,0,0,0,0,0,0,0,0,0,0,0
"310","6039501","0344226174","www.musee-nacre.com","HAUTS-DE-France","OISE",147861398,"Musée de la Nacre et de la Tabletterie","51","Rue Roger Salengro","60110","Méru","France","fr","open",49.2384518,2.13843498423966,12389,4619,17008,12759,4254,17013,13669,4437,18106,14313,4678,18991,15094,4925,20019,14631,5790,20421
"311","1437002","0231214213","www.ville-molay-littry.fr","NORMANDIE","CALVADOS",2405267465,"Musée de la Meunerie - Moulin de Marcy",NA,"Rue de Marcy","14330","Littry","France","fr","open",49.2277192,-0.9045211,2048,726,2774,2122,2000,4122,1863,2143,4006,2281,2281,4562,3292,3658,6950,3170,2707,5877
"312","1220201","0565738430","http://musee-fenaille.rodezagglo.fr/","OCCITANIE","AVEYRON",124625026,"Musée Fenaille","14","Place Eugène Raynaldy","12000","Rodez","France","fr","open",44.3490972,2.57659228429845,22436,8462,30898,21060,10972,32032,20247,16025,36272,25459,11555,37014,27639,11090,38729,6279,12063,18342
"313","1225401","0565672896","www.musees-aveyron.fr","OCCITANIE","AVEYRON",1434993410,"Musée des Arts et Métiers Traditionnels",NA,"C 2","12330","Salles-la-Source","France","fr","open",44.437582,2.5141463,4029,2410,6439,4344,2287,6631,3974,1783,5757,4507,1819,6326,4948,2458,7406,5575,1522,7097
"314","0119201","0474492042","www.archeologie-izernore.com","AUVERGNE-RHÔNE-ALPES","AIN",1357668479,"Musée Archéologique",NA,"Place de l'Église","01580","Izernore","France","fr","open",46.220134,5.5548124,1644,2174,3818,1047,1679,2726,1164,1952,3116,1485,3491,4976,1160,1860,3020,940,1590,2530
"315","1736901","0546092122","www.musee-ernest-cognacq.fr","NOUVELLE-AQUITAINE","CHARENTE-MARITIME",4200451910,"Musée Ernest Cognacq",NA,"Avenue Victor Bouthillier","17410","Saint-Martin-de-Ré","France","fr","open",46.2054197,-1.3652403,9047,4500,13547,8255,5261,13516,8951,5263,14214,9483,5712,15195,7062,5066,12128,7504,5383,12887
"316","0422701","0492756215",NA,"PROVENCE-ALPES-CÔTE D'AZUR","ALPES DE HAUTE PROVENCE",7973813938,"Musée archéologique",NA,"Venelle de la Béate","43600","Sainte-Sigolène","France","fr","open",45.2575515,4.2167147,591,112,703,502,110,612,672,120,792,789,193,982,643,388,1031,500,222,722
"317","7218199","0243473994","site de la ville","PAYS DE LA LOIRE","SARTHE",65554014,"Musée Vert Véron-de-Forbonnais","204","Avenue Jean Jaurès","72100","Le Mans","France","fr","open",47.98672035,0.207917453402311,16148,10765,26913,12903,12789,25692,3597,11808,15405,8738,11330,20068,13340,8107,21447,9392,8801,18193
"318","3620001","0254244731","www.argentomagus.com ou www.argentomagus.cc-argenton.fr","CENTRE-VAL DE LOIRE","INDRE",275239079,"Musée Archéologique d'Argentomagus",NA,"Impasse du Clos des Mersans","36200","Saint-Marcel","France","fr","open",46.600498,1.51631719,5930,4409,10339,5606,5253,10859,6547,3877,10424,6706,5828,12534,7792,6527,14319,7858,6455,14313
"319","5063901","0233693344","www.museesvilledieu.sitew.com","NORMANDIE","MANCHE",218157369,"Musée de la Poeslerie",NA,"Cour du Foyer","50800","Villedieu-les-Poêles","France","fr","open",48.84073,-1.221661075,3772,1056,4828,4292,1527,5819,4849,661,5510,5536,1132,6668,6757,376,7133,5931,0,5931
"320","1475401","0231817760","www.paleospace-villers.fr","NORMANDIE","CALVADOS",367285600,"Paléospace / Musée Paléontologique",NA,"Avenue Jean Moulin","14640","Villers-sur-Mer","France","fr","open",49.32785775,0.0133595937681979,52927,7152,60079,50543,7663,58206,44452,6328,50780,48901,7785,56686,47514,372,47886,33764,2611,36375
"321","2309601","0555520720","www.ville-gueret.fr/culture/musee.php","NOUVELLE-AQUITAINE","CREUSE",6222152324,"Musée d'Art et d'Archéologie",NA,"Route de la Cascade","23400","Bourganeuf","France","fr","open",45.9496263,1.7563312,353,1834,2187,1660,6052,7712,2823,7390,10213,3703,4779,8482,4280,4592,8872,5734,5636,11370
"322","6912301","0478384200","www.mtmad.fr","AUVERGNE-RHÔNE-ALPES","RHÔNE",188157107,"Musée Historique des Tissus",NA,"Rue de la Charité","69002","Lyon","France","fr","open",45.7533945,4.83132563480459,35711,18335,54046,49874,3947,53821,40980,19411,60391,30291,18385,48676,45135,23251,68386,34707,22283,56990
"323","5452801","0383641338","www.toul.fr","GRAND EST","MEURTHE ET MOSELLE",1198779245,"Musée d'Art et d'Histoire de Toul","25","Rue Gouvion Saint-Cyr","54200","Toul","France","fr","open",48.6784079,5.8911945,0,11548,11548,0,10385,10385,0,8927,8927,0,5197,5197,0,6658,6658,0,5239,5239
"324","6822404","0389324850","electropolis.edf.com","GRAND EST","HAUT-RHIN",369752515,"Musée Electropolis",NA,"Rue du Pâturage","68200","Mulhouse","France","fr","open",47.7490528,7.295155,11536,23047,34583,11746,28224,39970,31601,11904,43505,21445,10978,32423,28011,12477,40488,30679,7302,37981
"325","3210701","0562284717","site du département : www.gers-gascogne.com","OCCITANIE","GERS",395394221,"Musée de l'Armagnac",NA,"Rue Jules Ferry","32100","Condom","France","fr","open",43.9587501,0.3720146,1264,437,1701,1339,320,1659,1422,290,1712,1107,243,1350,2545,423,2968,2445,445,2890
"326","4410902","0251174500","www.museedesbeauxarts.nantes.fr","PAYS DE LA LOIRE","LOIRE-ATLANTIQUE",97962232,"Musée d'Art de Nantes",NA,"Quai de la Fosse","44003","Nantes","France","fr","open",47.2067071,-1.57165659765821,122653,203643,326296,194634,60323,254957,4592,95545,100137,21316,208944,230260,18470,200187,218657,17621,136028,153649
"327","8400704","0490863384","www.musee-calvet-avignon.com ou www.museecalvet.org et www.musee-lapidaire.org","PROVENCE-ALPES-CÔTE D'AZUR","VAUCLUSE",1490236424,"Musée Calvet (et musée Lapidaire)",NA,"Cours du Musée Calvet","84000","Avignon","France","fr","open",43.9469675,4.8036302,0,41175,41175,6678,19200,25878,13175,20867,34042,15778,25531,41309,13431,21035,34466,12917,21016,33933
"328","7137301","0385304583","www.ecomusee-de-la-bresse.com","BOURGOGNE-FRANCHE-COMTE","SAONE ET LOIRE",7419064525,"Musée du Terroir",NA,"Rue des Quartiers","71470","Romenay","France","fr","open",46.503251,5.067591,2083,873,2956,2114,871,2985,2139,1141,3280,2258,1528,3786,2613,1344,3957,3036,1207,4243
"329","5905301","0359731550","http://forumantique.lenord.fr/","HAUTS-DE-France","NORD",54367331,"Forum Antique de Bavay",NA,"Sentier Promenade du Rempart","59570","Bavay","France","fr","open",50.29911105,3.79156153828687,22674,7559,30233,22377,5074,27451,23659,6694,30353,22688,9513,32201,18884,4179,23063,22752,9309,32061
"330","6276501","0321380094","www.patrimoines-saint-omer.fr","HAUTS-DE-France","PAS-DE-CALAIS",166832494,"Musée de l'Hôtel Sandelin",NA,"Rue Carnot","62500","Saint-Omer","France","fr","open",50.7491635,2.2540849375,6490,8771,15261,8456,8777,17233,5107,11074,16181,7123,8157,15280,4393,10642,15035,7635,8610,16245
"331","7510608","0155427720","www.zadkine.paris.fr","ÎLE-DE-France","PARIS",153776401,"Musée Zadkine",NA,"Passage Commun B6","75006","Paris","France","fr","open",48.84281085,2.3337992380791,32835,0,32835,30801,0,30801,3349,17400,20749,0,23249,23249,27188,21419,48607,11928,28396,40324
"332","7904901","0549743224","www.agglo2b.fr","NOUVELLE-AQUITAINE","DEUX-SEVRES",48789536,"Musée de Bressuire",NA,"Rue Aristide Briand","79300","Bressuire","France","fr","open",46.84205515,-0.492897616777338,0,3810,3810,0,3315,3315,0,2539,2539,0,784,784,0,2363,2363,0,1233,1233
"333","1106901","0468777370","Site de la ville","OCCITANIE","AUDE",842466709,"Musée des Beaux-Arts",NA,"Rue de Verdun","11000","Carcassonne","France","fr","open",43.212599,2.3550441,0,25110,25110,0,64928,64928,0,66216,66216,0,70412,70412,0,73579,73579,0,49366,49366
"334","3000702","0466863040","site de la ville - www.ville-ales.fr","OCCITANIE","GARD",130822767,"Musée du Colombier",NA,"Rue Jean Mayodon","30100","Alès","France","fr","open",44.1284065,4.08031181745859,1360,9322,10682,589,10224,10813,733,10479,11212,0,11885,11885,0,12332,12332,0,11858,11858
"335","1803306","0248578245","Site de la ville www.ville-bourges.fr","CENTRE-VAL DE LOIRE","CHER",6604772585,"Musée des Meilleurs Ouvriers de France",NA,"Place Étienne Dolet","18000","Bourges","France","fr","open",47.0814193,2.3993842,0,0,0,5157,2068,7225,0,19174,19174,0,18254,18254,0,17224,17224,0,18298,18298
"336","0840901","0324299880","www.chateau-fort-sedan.fr","GRAND EST","ARDENNES",1874188907,"Musée du Château-Fort",NA,"Avenue de la Dernière Cartouche","08140","Bazeilles","France","fr","open",49.6817859,4.9754729,50826,3977,54803,56082,2732,58814,55930,2846,58776,55491,2013,57504,56704,1482,58186,50794,1777,52571
"337","4716701","0553656816","www.ville-mezin.fr/musee.html","NOUVELLE-AQUITAINE","LOT ET GARONNE",3110116210,"Musée du Liège et du Bouchon",NA,"Rue du Puits","47170","Mézin","France","fr","open",44.0564056,0.2561249,3521,1052,4573,3330,820,4150,3469,926,4395,3317,978,4295,3365,1157,4522,3919,939,4858
"338","3018906","0466763570","www.carreartmusee.com","OCCITANIE","GARD",249023783,"Carré d'Art Musée d'Art Contemporain de Nîmes","16","Place de la Maison Carrée","30000","Nîmes","France","fr","open",43.8379778,4.35506513906278,15086,15323,30409,10087,43268,53355,10267,36924,47191,12043,28962,41005,16726,24081,40807,17840,23383,41223
"339","4900703","0241241845","Site de la ville","PAYS DE LA LOIRE","MAINE-ET-LOIRE",624532610,"Musée Jean Lurcat et de la Tapisserie Contemporaine",NA,"Rue Gay-Lussac","49035","Angers","France","fr","open",47.4780639,-0.5575814,13756,41206,54962,19234,39318,58552,15361,40994,56355,15793,38340,54133,15966,45130,61096,15386,43502,58888
"340","6702101","0388089472","www.musee-foliemarco.com","GRAND EST","BAS-RHIN",79550929,"Musée de la Folie Marco",NA,"Rue du Docteur Sultzer","67140","Barr","France","fr","open",48.4102662,7.45114422164834,1249,2341,3590,1163,1281,2444,1705,1409,3114,1874,1934,3808,1865,2685,4550,2959,3108,6067
"341","7510503","0140795479","www.mnhn.fr","ÎLE-DE-France","PARIS",83913793,"Grande Galerie de l'Evolution (Muséum National d'Histoire Naturelle)",NA,"Rue Geoffroy Saint-Hilaire","75005","Paris","France","fr","open",48.8421055,2.35624382180362,404497,344572,749069,338684,352704,691388,313742,293110,606852,414944,276628,691572,401799,367931,769730,498855,253566,752421
"342","7820801","0134522880","www.museedelaville.agglo-sqy.fr","ÎLE-DE-France","YVELINES",1290290099,"Musée de la Ville",NA,"Quai François Truffaut","78180","Montigny-le-Bretonneux","France","fr","open",48.7831521,2.042426,2816,5858,8674,1806,6671,8477,2298,2239,4537,1680,2415,4095,2400,7144,9544,4241,3759,8000
"343","1610202","0545362110","www.musees-cognac.fr","NOUVELLE-AQUITAINE","CHARENTE",1021853,"Musée des Arts du Cognac (Annexe musée municipal)","Place","Place de la Salle Verte","16100","Cognac","France","fr","open",45.69551055,-0.332166145520677,5979,2693,8672,6232,2044,8276,7224,2562,9786,8795,5581,14376,6143,5285,11428,6430,4736,11166
"344","8619402","0549410753","www.musees-poitiers.org ou www.alienor.org","NOUVELLE-AQUITAINE","VIENNE",40140547,"Musée Sainte-Croix",NA,"Rue Paschal le Coq","86000","Poitiers","France","fr","open",46.57912245,0.347754414714965,7997,28767,36764,6596,25065,31661,6476,25150,31626,5472,22024,27496,5635,22882,28517,4731,20998,25729
"345","8616502","0549910232","www.montmorillon.fr","NOUVELLE-AQUITAINE","VIENNE",3817108642,"Musée d'Art et d'Histoire de Montmorillon",NA,"Rue Saint-Martin","86510","Brux","France","fr","open",46.2361732,0.1936808,0,1160,1160,0,6575,6575,0,4206,4206,0,4784,4784,0,6602,6602,0,6892,6892
"346","0602901","0493385526","Site de la ville","PROVENCE-ALPES-CÔTE D'AZUR","ALPES-MARITIMES",64917198,"Musée de la Castre",NA,"Place de la Castre",NA,"Cannes","France","fr","open",43.5501472,7.01020442856012,23514,15000,38514,14172,15632,29804,12271,11424,23695,12584,14226,26810,17330,18844,36174,13134,16806,29940
"347","0608304","0489815250","www.museecocteaumenton.fr","PROVENCE-ALPES-CÔTE D'AZUR","ALPES-MARITIMES",1837011704,"Musée Jean Cocteau Collection Séverin Wunderman",NA,"Quai de Monléon","06500","Menton","France","fr","open",43.7747355,7.5057931,13752,25787,39539,31998,16823,48821,27314,11156,38470,30231,13192,43423,41413,16492,57905,44987,18097,63084
"348","8311901","0494178410","www.saint-tropez.tv/html/annonciade.html","PROVENCE-ALPES-CÔTE D'AZUR","VAR",179780946,"Musée de l'Annonciade",NA,"Place Georges Grammont","83990","Saint-Tropez","France","fr","open",43.271077,6.63705403060844,25275,5342,30617,24617,4994,29611,28736,6250,34986,30406,9039,39445,31614,6633,38247,33831,7586,41417
"349","2505605","0381878312","www.citadelle.com","BOURGOGNE-FRANCHE-COMTE","DOUBS",6354947603,"Musée de la résistance et de la Déportation",NA,"Chemin de Ronde de la Citadelle","25000","Besançon","France","fr","open",47.2290324,6.0349109,48967,0,48967,36488,12162,48650,33998,11332,45330,44408,14800,59208,53441,0,53441,51706,0,51706
"350","5605701","0297231527","www.museedufaouet.fr","BRETAGNE","MORBIHAN",70306579,"Musée du Faouët",NA,"Rue de Quimper","56320","Le Faouët","France","fr","open",48.03169705,-3.49062171092011,17299,4087,21386,13780,3945,17725,12585,2898,15483,11375,3272,14647,11883,4452,16335,14393,4166,18559
"351","6748209","0388233131","www.musees-strasbourg.eu","GRAND EST","BAS-RHIN",40220422,"Musée d'Art Moderne et Contemporain de Strasbourg",NA,"Place Hans-Jean Arp","67003","Strasbourg","France","fr","open",48.5794799,7.73609964763117,54017,101402,155419,47402,79351,126753,49095,77215,126310,50528,82825,133353,57411,101330,158741,43813,83075,126888
"352","5313001","0253741230","http://laval.fr/musees/musee-du-vieux-château ou http://musees.laval.fr/","PAYS DE LA LOIRE","MAYENNE",3773677487,"Musée du Vieux Château",NA,"Rue du Val de Mayenne","53000","Laval","France","fr","open",48.068577,-0.7707286,7843,33416,41259,8341,25768,34109,9986,23638,33624,8058,18801,26859,6850,18765,25615,17163,0,17163
"353","4417701","0240809013","www.musee-vignoble-nantais.eu","PAYS DE LA LOIRE","LOIRE-ATLANTIQUE",79384224,"Musée du Vignoble Nantais",NA,"Rue Pierre Abélard","44330","Le Pallet","France","fr","open",47.1344821,-1.33003193778379,3263,5544,8807,3022,6403,9425,3432,4995,8427,3492,5691,9183,3468,2592,6060,4410,4628,9038
"354","2903901","0298971020","www.musee-peche.fr","BRETAGNE","FINISTERE",3986935,"Musée de la Pêche",NA,"Rue Militaire","29900","Concarneau","France","fr","open",47.87218475,-3.91601304150886,21695,16345,38040,21274,17543,38817,18654,16301,34955,21899,19762,41661,20256,14897,35153,20283,14570,34853
"355","4205901","0477942329","www.museeduchapeau.com","AUVERGNE-RHÔNE-ALPES","LOIRE",6050847032,"Atelier - Musée du Chapeau","31","Rue Martouret","42140","Chazelles-sur-Lyon","France","fr","open",45.6386575,4.395141,15716,5611,21327,16992,5878,22870,15683,6700,22383,19619,5030,24649,18860,6996,25856,16051,10219,26270
"356","0236102","0323613536","www.familistere.com","HAUTS-DE-France","AISNE",1418418104,"Familistère de Guise",NA,"Cité Familistère","02120","Guise","France","fr","open",49.9045566,3.6252747,62312,3584,65896,60128,12239,72367,56799,8491,65290,54888,8763,63651,54299,8494,62793,38796,14791,53587
"357","6748210","0390240485","www.musees.strasbourg.eu","GRAND EST","BAS-RHIN",459628388,"Musée Zoologique de Strasbourg",NA,"Boulevard de la Victoire","67085","Strasbourg","France","fr","open",48.5827722,7.7647316,8184,33765,41949,7785,33133,40918,9571,30927,40498,7345,28262,35607,3705,19376,23081,32706,0,32706
"358","7857501","0130856960","www.coubertin.fr","ÎLE-DE-France","YVELINES",951328,"Collections de la Fondation de Coubertin",NA,NA,"78470","Saint-Rémy-lès-Chevreuse","France","fr","open",48.7054888,2.071109,1258,453,1711,682,312,994,59,0,59,1160,572,1732,1140,509,1649,1066,504,1570
"359","7511601","0156525345","http://www.guimet.fr/fr/musee-dennery/histoire-du-musee-dennery","ÎLE-DE-France","PARIS",80848762,"Musée d'Ennery",NA,"Avenue Foch","75116","Paris","France","fr","open",48.8714924,2.28143483729216,0,721,721,0,758,758,0,777,777,0,1111,1111,0,1077,1077,0,2040,2040
"360","7510402","0144781233","www.centrepompidou.fr","ÎLE-DE-France","PARIS",5918699678,"Musée National d'Art Moderne (Centre National d'Art et de Culture Georges Pompidou)",NA,"Rue Joliot-Curie","91190","Le Moulon","France","fr","open",48.7094092,2.1666145,2620481,1070337,3690818,2484190,1014669,3498859,2461390,967298,3428688,2233094,887209,3120303,2517861,1002502,3520363,2745810,1086601,3832411
"361","7635104","0235413728","www.museum-lehavre.fr ou site de la ville","NORMANDIE","SEINE-MARITIME",630176315,"Muséum d'Histoire Naturelle",NA,"Place du Vieux Marché","76600","Le Havre","France","fr","open",49.4877689,0.109078564111387,48635,0,48635,25300,23000,48300,2675,40000,42675,0,23206,23206,0,41533,41533,0,41945,41945
"362","3155506","0562271150","htt://toulousainsdetoulouse.fr","OCCITANIE","HAUTE-GARONNE",247081244,"Musée du Vieux Toulouse",NA,"Rue du May","31000","Toulouse","France","fr","open",43.6023148,1.4431296,6068,1004,7072,6573,978,7551,6130,1317,7447,6296,1299,7595,5959,1072,7031,6346,935,7281
"363","8408701","0490511760","www.theatre-antique.com","PROVENCE-ALPES-CÔTE D'AZUR","VAUCLUSE",219528069,"Musée Municipal",NA,"Rue Madeleine Roch","84100","Orange","France","fr","open",44.1361394,4.80773209836479,50679,998,51677,56334,0,56334,49159,0,49159,56584,0,56584,57305,0,57305,58941,0,58941
"364","5110801","0326693853","www.chalonsenchampagne.fr/culture/musees","GRAND EST","MARNE",323588585,"Musée Municipal",NA,"Place Godart","51000","Châlons-en-Champagne","France","fr","open",48.9564601,4.3638072,2124,9705,11829,1361,9810,11171,1872,9436,11308,1231,9661,10892,1551,11012,12563,1295,16800,18095
"365","6047103","0344440359","www.ville-noyon.fr/Le-musee-Jean-Calvin.html","HAUTS-DE-France","OISE",476735511,"Musée Jean Calvin",NA,"Rue du Porcelet","60400","Noyon","France","fr","open",49.5817505,2.9984424,2014,1006,3020,2778,782,3560,1929,647,2576,2029,892,2921,2215,791,3006,2156,963,3119
"366","4719501","0553652111","Site des musées aquitains ou www.nerac.fr","NOUVELLE-AQUITAINE","LOT ET GARONNE",175744724,"Musée du Château Henri IV","3","Rue Sederie","47600","Nérac","France","fr","open",44.1360265,0.341809847508077,8851,4268,13119,13768,3177,16945,8409,6817,15226,14102,9112,23214,15201,7518,22719,17469,8353,25822
"367","4900701","0241053800","www.angers.fr/mba","PAYS DE LA LOIRE","MAINE-ET-LOIRE",126965407,"Musée des Beaux-Arts","14","Rue du Musée","49100","Angers","France","fr","open",47.4689171,-0.55450213088067,30625,95971,126596,17743,54694,72437,20444,63236,83680,17692,63112,80804,20525,60396,80921,18977,49644,68621
"368","4929201","0241784275","www.musee-vigne-vin-anjou.fr","PAYS DE LA LOIRE","MAINE-ET-LOIRE",2427017251,"Musée de la Vigne et du Vin d'Anjou",NA,"Rue de la Coudraye","49750","Angers","France","fr","open",47.2999784,-0.6335965,3230,877,4107,3627,795,4422,4218,1205,5423,5223,893,6116,5337,1779,7116,6250,1466,7716
"369","5904301","0328491270","Site de la ville","HAUTS-DE-France","NORD",81168271,"Musée Benoît de Puydt",NA,"Rue des Viviers","59270","Bailleul","France","fr","open",50.7407272,2.73450331275047,2169,2801,4970,1475,3199,4674,1675,2736,4411,2184,2646,4830,4082,557,4639,2375,2196,4571
"370","5935003","0328553080","http://mhn.lille.fr","HAUTS-DE-France","NORD",41065833,"Musée d'Histoire Naturelle et de Géologie","19","Rue de Bruxelles","59000","Lille","France","fr","open",50.6266587,3.06701952992126,46156,73915,120071,44301,48357,92658,85663,0,85663,109378,0,109378,89675,0,89675,67520,0,67520
"371","3306306","0556101400","Site de la ville -  www.mairie-bordeaux.fr","NOUVELLE-AQUITAINE","GIRONDE",79981701,"Musée des Arts Décoratifs et du Design","33","Rue Bouffard","33000","Bordeaux","France","fr","open",44.8388752,-0.580228639189566,16371,40528,56899,22651,49401,72052,15856,32407,48263,16027,27052,43079,11004,35036,46040,8373,34716,43089
"372","0608816","0492293700","www.arts-asiatiques.com","PROVENCE-ALPES-CÔTE D'AZUR","ALPES-MARITIMES",140260291,"Musée Départemental des Arts Asiatiques","33","Avenue des Baumettes","06000","Nice","France","fr","open",43.694615,7.24887277049937,3186,47035,50221,7356,46332,53688,3820,40336,44156,986,45948,46934,0,60382,60382,0,72475,72475
"373","7428102","0450706949","Site de la ville","AUVERGNE-RHÔNE-ALPES","HAUTE-SAVOIE",5537445278,"Musée du Chablais","2","Rue Michaud","74200","Thonon-les-Bains","France","fr","open",46.3735929,6.4782107,1179,1656,2835,1973,1448,3421,2045,2851,4896,2153,3550,5703,4839,0,4839,1223,1913,3136
"374","5955501","0359731616","www.musverre.lenord.fr","HAUTS-DE-France","NORD",484521029,"MusVerre",NA,"Rue du Général de Gaulle","59216","Sars-Poteries","France","fr","open",50.1664701,4.03128538363987,15724,17935,33659,26402,20233,46635,3260,43743,47003,3406,2645,6051,8962,6808,15770,9437,9271,18708
"375","4008801","0558741291","http://www.dax.fr/musee-de-borda - Site des musées aquitains","NOUVELLE-AQUITAINE","LANDES",5223344896,"Musée de Borda","11 bis","Rue des Carmes","40100","Dax","France","fr","open",43.7105638,-1.0538641,3210,8813,12023,3035,8277,11312,3473,7693,11166,2811,7886,10697,1989,6143,8132,2553,6614,9167
"376","1734701","0546250972","www.angely.net","NOUVELLE-AQUITAINE","CHARENTE-MARITIME",89447700,"Musée Municipal des Cordeliers","9","Rue Régnaud","17400","Saint-Jean-d'Angély","France","fr","open",45.94263465,-0.524208508591049,319,7802,8121,418,7298,7716,962,7649,8611,999,7542,8541,576,6432,7008,807,4482,5289
"377","9529501","0134674507","www.valdoise.fr/content/content15651.html","ÎLE-DE-France","VAL D'OISE",464777467,"Musée Archéologique du Val d'Oise",NA,"Place du Château","95450","Guiry-en-Vexin","France","fr","open",49.1089657,1.8496944,0,20612,20612,0,15231,15231,4073,11643,15716,2756,10010,12766,2504,10205,12709,0,10901,10901
"378","2705601","0232466323","www.ville-bernay27.fr/le_musee_des_beaux_arts.html","NORMANDIE","EURE",1848184518,"Musée Municipal",NA,"Place de la République","27300","Bernay","France","fr","open",49.0891535,0.5986718,1059,6526,7585,1412,6758,8170,2578,9098,11676,1179,7090,8269,1227,9288,10515,2448,13103,15551
"379","2432202","0553534736","www.museemilitaire-perigord.fr","NOUVELLE-AQUITAINE","DORDOGNE",75346425,"Musée Militaire - Souvenir du Périgord",NA,"Rue 26e Régiment d'Infanterie","24000","Périgueux","France","fr","open",45.1794786,0.713209632058521,2218,1000,3218,2086,783,2869,1858,984,2842,2064,637,2701,1860,1368,3228,1774,1124,2898
"380","5806201","0386606762","www.cg58.fr","BOURGOGNE-FRANCHE-COMTE","NIÈVRE",3618004518,"Musée du Septennat",NA,"Place du Château","58120","Château-Chinon (Ville)","France","fr","open",47.0672537,3.9351818,6963,1633,8596,7109,1758,8867,6967,2339,9306,7762,1778,9540,8538,2282,10820,9344,3469,12813
"381","2100801","0380969623","www.alesia.com","BOURGOGNE-FRANCHE-COMTE","CÔTE D’OR",1614573,"Musée Alésia - Centre d'Interprétation","1","D 103T","21150","Alise-Sainte-Reine","France","fr","open",47.5357138,4.46920646463415,13713,56209,69922,50994,13829,64823,60993,11958,72951,72306,16058,88364,69949,19318,89267,86154,15231,101385
"382","5226901","0325868640","http://www.musees-langres.fr/maison-des-lumieres-denis-diderot/","GRAND EST","HAUTE-MARNE",63714311,"Maison des Lumières Denis Diderot","1","Place de Verdun","52200","Langres","France","fr","open",47.86621305,5.33160750271484,4418,6457,10875,5000,6600,11600,4175,6578,10753,4857,4792,9649,8065,5821,13886,2558,3536,6094
"383","6754401","0388059663","www.ville-wissembourg.eu ou www.musee-wissembourg.webmuseo.com","GRAND EST","BAS-RHIN",167263621,"Musée Westercamp",NA,"Rue du Musée","67160","Wissembourg","France","fr","open",49.0389525,7.94487220588235,0,461,461,0,398,398,0,669,669,0,4472,4472,0,6492,6492,0,5576,5576
"384","4630901","0565370707","www.musee-automate.fr","OCCITANIE","LOT",1074571594,"Musée de l'Automate",NA,"Place de l'Abbaye","46200","Souillac","France","fr","open",44.8936695,1.4768774,10780,2021,12801,12929,960,13889,12335,3126,15461,15363,3143,18506,16729,3168,19897,15952,3151,19103
"385","8313703","0494368101","Site de la ville","PROVENCE-ALPES-CÔTE D'AZUR","VAR",2196651226,"Musée d'Art de Toulon - M.A.T.","113","Boulevard Général Leclerc","83000","Toulon","France","fr","open",43.1263031,5.9272107,0,16901,16901,0,49657,49657,0,31411,31411,0,28696,28696,0,26803,26803,0,23825,23825
"386","5244801","0325073150","Site de la mairie","GRAND EST","HAUTE-MARNE",65662699,"Musée Municipal",NA,"Allée Jean-François Lescuyer","52100","Saint-Dizier","France","fr","open",48.63793305,4.94811769807335,0,4527,4527,0,3437,3437,0,5298,5298,0,5383,5383,0,6710,6710,0,6210,6210
"387","4126901","0254772613","www.vendome.eu/intro/1p1e-421-musee-vendome.html-vendome.html ou www.musees.regioncentre.fr","CENTRE-VAL DE LOIRE","LOIR ET CHER",541957843,"Musée de Vendôme",NA,"Allée de Yorktown","41100","Vendôme","France","fr","open",47.7907832,1.0689238,0,13142,13142,0,14774,14774,0,14943,14943,0,16940,16940,0,15357,15357,483,11539,12022
"388","0912201","0534098383","www.sesta.fr ou www.ariege.com/chateaufoix/index.html","OCCITANIE","ARIEGE",3241536133,"Musée Départemental de l'Ariège",NA,"Rue du Rocher","09000","Foix","France","fr","open",42.9657002,1.6047597,82654,8301,90955,88812,8286,97098,81231,7110,88341,76476,7295,83771,80152,7638,87790,77938,7383,85321
"389","1209602","0565441063","www.museeduscaphandre.com - musees.aveyron.fr","OCCITANIE","AVEYRON",152865476,"Musée Joseph Vaylet",NA,"Rue Droite","12500","Espalion","France","fr","open",44.521226,2.76232835136816,2065,3274,5339,3149,2500,5649,2452,2850,5302,2183,2889,5072,2287,2215,4502,2462,1560,4022
"390","1300105","0442210653","www.atelier-cezanne.com","PROVENCE-ALPES-CÔTE D'AZUR","BOUCHES DU RHONE",88614075,"Musée- Atelier de Paul Cézanne",NA,"Rue des Bremondis","13626","Aix-en-Provence","France","fr","open",43.53075485,5.44723930755179,72881,6239,79120,59851,8162,68013,54925,7754,62679,60651,8304,68955,58721,8774,67495,58503,7569,66072
"391","0134301","0385363122","www.musees.ain.fr","AUVERGNE-RHÔNE-ALPES","AIN",148365323,"Musée de la Bresse - Domaine des Planons",NA,"Chemin des Seiglières","01380","Saint-Cyr-sur-Menthon","France","fr","open",46.28177465,4.98246243180243,10693,7504,18197,9852,7173,17025,10274,5985,16259,12331,9331,21662,12866,9377,22243,13191,7639,20830
"392","3901302","0384664045","http://www.juramusees.com/musee-vigne-vin/musee-vigne-vin.htm","BOURGOGNE-FRANCHE-COMTE","JURA",2637893946,"Musée de la Vigne et du Vin",NA,"Passage Saint-Vernier","39600","Arbois","France","fr","open",46.9035466,5.7751443,3953,2881,6834,3506,2012,5518,3596,1607,5203,2611,1748,4359,3374,2033,5407,3795,2576,6371
"393","4221804","0477438323","www.musee-mine.saint-etienne.fr OU site de la ville : www.saint-etienne.fr","AUVERGNE-RHÔNE-ALPES","LOIRE",49047701,"Musée de la Mine / Site Couriot","3","Boulevard Maréchal Franchet d'Espèrey","69400","Saint-Étienne","France","fr","open",45.4382508,4.37613171303228,30551,23101,53652,33155,42865,76020,29629,43521,73150,28347,38185,66532,28630,30486,59116,28471,27520,55991
"394","2B03301","0495310912","http://musee.bastia.corsica/fr/le-musee/le-palais-des-gouverneurs-1777.html","CORSE","HAUTE-CORSE",590087366,"Musée d'Histoire de Bastia",NA,NA,"20290","Lucciana","France","fr","open",42.54204815,9.49692095151915,17483,14651,32134,18303,16120,34423,12499,12235,24734,10289,10460,20749,12150,7138,19288,15462,5978,21440
"395","7635105","0235190985","Site de la ville - www.ville-lehavre.fr","NORMANDIE","SEINE-MARITIME",10067814,"La Maison de l'Armateur","3","Quai de l'Île","76600","Le Havre","France","fr","open",49.4869259,0.112771549924735,6107,6782,12889,10407,10814,21221,6112,7860,13972,6299,9908,16207,7152,9003,16155,4857,8163,13020
"396","6066401","0364588000","www.m-a-o.org","HAUTS-DE-France","OISE",6634451503,"Musée Archéologique de l'Oise",NA,"Grande Rue de Vendeuil","60120","Vendeuil-Caply","France","fr","open",49.6101842,2.2973429,8140,1500,9640,4169,2578,6747,2403,3015,5418,2618,3650,6268,4391,2462,6853,3134,3795,6929
"397","5312201","0243581320","www.museedejublains.fr","PAYS DE LA LOIRE","MAYENNE",8292313,"Musée Archéologique Départemental de Jublains",NA,"Rue de la Libération","53160","Jublains","France","fr","open",48.2545411,-0.497584374211756,11267,10177,21444,18918,10564,29482,16765,11752,28517,14966,12241,27207,18258,11284,29542,14788,12703,27491
"398","2105402","0380249870","www.musees-bourgogne.org ou www.beaune.fr","BOURGOGNE-FRANCHE-COMTE","CÔTE D’OR",371712800,"Musée des Beaux-Arts",NA,"Rempart Madeleine","21200","Beaune","France","fr","open",47.0214963,4.8398035,919,4310,5229,3699,2489,6188,2972,2095,5067,4664,2400,7064,5567,2319,7886,5834,2306,8140
"399","5439501","0383401486","www.ecole-de-nancy.com","GRAND EST","MEURTHE ET MOSELLE",49791497,"Musée de l'Ecole de Nancy",NA,"Rue du Sergent Blandan","54100","Nancy","France","fr","open",48.680552,6.16607581903806,24843,14384,39227,27916,14668,42584,25122,15243,40365,25840,14812,40652,24359,30862,55221,24411,19700,44111
"400","1738501","0546750516","www.musee-ile-oleron.fr","NOUVELLE-AQUITAINE","CHARENTE-MARITIME",1846520665,"Musée de l'Ile d'Oléron",NA,"Rue Aliénor d'Aquitaine","17310","Saint-Pierre-d'Oléron","France","fr","open",45.9428107,-1.3066515,8118,3441,11559,9830,3279,13109,8892,3413,12305,10554,3414,13968,9518,2666,12184,9330,3462,12792
"401","4019201","0558750045","www.mont-de-marsan.org/decouvrir/decouv_muse.html ou Site des musées aquitains","NOUVELLE-AQUITAINE","LANDES",580649793,"Musée Despiau-Wlérick","6","Place Marguerite de Navarre","40000","Mont-de-Marsan","France","fr","open",43.8925268,-0.4993529,0,19597,19597,0,10972,10972,0,35443,35443,0,12377,12377,0,10722,10722,0,27557,27557
"402","3306304","0556015100","www.musee-aquitaine-bordeaux.fr","NOUVELLE-AQUITAINE","GIRONDE",80024893,"Musée d'Aquitaine",NA,"Musée d'Aquitaine","33000","Bordeaux","France","fr","open",44.8356189,-0.574690610123272,50036,101573,151609,47796,95653,143449,46208,140891,187099,43245,95982,139227,31540,122816,154356,16796,130263,147059
"403","2158401","0380641951","Site des musées de Bourgogne ou www.saulieu.fr","BOURGOGNE-FRANCHE-COMTE","CÔTE D’OR",1870447615,"Musée Municipal François Pompon",NA,"Place Docteur Roclore","21210","Saulieu","France","fr","open",47.2796264,4.2298054,3308,6420,9728,3633,6748,10381,3147,6109,9256,2903,5649,8552,2788,5523,8311,2868,5544,8412
"404","8816001","0329822033","Site du conseil général - www.vosges.fr","GRAND EST","VOSGES",100809875,"Musée Départemental d'Art Ancien et Contemporain","1","Place Lagarde","88000","Épinal","France","fr","open",48.1727635,6.4463261856928,3297,14838,18135,2776,12477,15253,3056,10728,13784,2588,15194,17782,2909,11017,13926,2376,10749,13125
"405","6005701","0344104050","http://mudo.oise.fr/","HAUTS-DE-France","OISE",556458814,"MUDO - Musée de l'Oise",NA,"Rue Saint-Pierre","60000","Beauvais","France","fr","open",49.4329907,2.07960362411342,0,48609,48609,0,54858,54858,0,57977,57977,0,69745,69745,0,30686,30686,0,19913,19913
"406","9207201","0146292200","www.sevresciteceramique.fr","ÎLE-DE-France","HAUTS DE SEINE",7325289618,"Cité de la céramique - Sèvres & Limoges",NA,"Rue de la Cité","79000","Niort","France","fr","open",46.312254,-0.4461027,38873,27520,66393,29627,21928,51555,40409,24464,64873,35402,31923,67325,57047,31727,88774,23858,22331,46189
"407","1903101","0555181770","www.musee-labenche.com ou www.brive.net","NOUVELLE-AQUITAINE","CORREZE",975799385,"Musée Labenche d'Art et d'Histoire","4","Rue Champanatier","19100","Brive-la-Gaillarde","France","fr","open",45.1563488,1.5277125,1493,23348,24841,1655,32820,34475,1692,43247,44939,1699,46823,48522,2078,36701,38779,1545,35599,37144
"408","2300801","0555830830","www.cite-tapisserie.fr","NOUVELLE-AQUITAINE","CREUSE",225393416,"Musée Départemental de la Tapisserie",NA,"Rue Vieille","23200","Aubusson","France","fr","open",45.9572515,2.17078170588235,30000,10000,40000,32527,12030,44557,28582,10247,38829,16161,3407,19568,13038,4368,17406,14247,4967,19214
"409","0731601","0475608886","www.rhonecrussol.fr","AUVERGNE-RHÔNE-ALPES","ARDECHE",68332777,"Musée et Site Archéologiques",NA,"Rue des Ruines","07130","Soyons","France","fr","open",44.8879269,4.85077629560044,12670,2040,14710,11807,1803,13610,10591,1726,12317,10488,1691,12179,12400,1782,14182,11822,1784,13606
"410","7654004","0235985510","http://museedesantiquites.fr","NORMANDIE","SEINE-MARITIME",64180958,"Musée des Antiquités de la Seine-Maritime","198","Rue Beauvoisine","76000","Rouen","France","fr","open",49.4469796,1.09947132578471,3151,32716,35867,5144,22814,27958,157,27607,27764,2362,26398,28760,1716,28460,30176,1868,24511,26379
"411","3930002","0384476430","Site des musées de la région","BOURGOGNE-FRANCHE-COMTE","JURA",631011962,"Musée des Beaux-Arts",NA,"Place Philibert de Chalon","39000","Lons-le-Saunier","France","fr","open",46.6760636,5.5535325,1019,3348,4367,1110,7230,8340,1233,9243,10476,1064,4150,5214,897,2542,3439,790,2902,3692
"412","6912304","0437236534","www.imprimerie-lyon.fr","AUVERGNE-RHÔNE-ALPES","RHÔNE",62271798,"Musée de l'Imprimerie et de la Communication Graphique",NA,"Rue de la Poulaillerie","69002","Lyon","France","fr","open",45.76427995,4.8347027871875,23530,20865,44395,20305,11924,32229,16384,10094,26478,26421,0,26421,13942,8309,22251,17453,13817,31270
"413","3523801","0223406670","www.musee-bretagne.fr","BRETAGNE","ILE ET VILAINE",7422696,"Musée de Bretagne",NA,"Boulevard Magenta","35000|35700|35200","Rennes","France","fr","open",48.10513205,-1.6741388704016,19088,48247,67335,22416,53564,75980,15364,46388,61752,20258,45972,66230,18428,42992,61420,14381,36150,50531
"414","6718002","0388733041","http://www.ville-haguenau.fr/musee-alsacien","GRAND EST","BAS-RHIN",606195509,"Musée Alsacien",NA,"Place Joseph Thierry","67500","Haguenau","France","fr","open",48.8147979,7.7893977,948,231,1179,723,896,1619,828,1260,2088,1147,1654,2801,1136,2920,4056,1908,2654,4562
"415","6282601","0321056262","www.letouquet-musee.com/","HAUTS-DE-France","PAS-DE-CALAIS",156284015,"Musée du Touquet Paris-Plage",NA,"Avenue du Château","62520","Le Touquet-Paris-Plage","France","fr","open",50.515136,1.60820986956521,7012,8485,15497,6499,7805,14304,8066,6695,14761,11588,7083,18671,10674,5847,16521,3336,3490,6826
"416","3018904","0466767370","www.nimes.fr/index.php?id=283","OCCITANIE","GARD",39707615,"Musée du Vieux Nîmes",NA,"Place Abbé Pierre",NA,"Nîmes","France","fr","open",43.8379184,4.36040659845317,7527,4185,11712,1200,12680,13880,4463,10981,15444,570,16513,17083,1698,16035,17733,2103,17501,19604
"417","3035101","0490274966","Site du conseil général","OCCITANIE","GARD",908930249,"Musée Pierre de Luxembourg",NA,"Rue de la République","30400","Villeneuve-lès-Avignon","France","fr","open",43.9637314,4.7968264,2931,3231,6162,2838,2811,5649,2306,3269,5575,2676,3251,5927,3011,3120,6131,2699,2523,5222
"418","8101201","0563339030","http://musee-cayla.tarn.fr/","OCCITANIE","TARN",3134866346,"Musée Eugénie et Maurice Guérin",NA,"Sentier Littéraire","81140","Andillac","France","fr","open",44.0098937,1.8996887,1701,2775,4476,1433,2064,3497,1696,2544,4240,1079,2045,3124,1852,2485,4337,1460,2405,3865
"419","1300107","0488718181","www.museum-aix-en-provence.org","PROVENCE-ALPES-CÔTE D'AZUR","BOUCHES DU RHONE",86887992,"Muséum d'Histoire Naturelle","166","Avenue Jean Monnet","13090","Aix-en-Provence","France","fr","open",43.5333952,5.42369488957378,2107,15830,17937,3140,9957,13097,3779,15554,19333,1170,11969,13139,2047,23470,25517,9203,32138,41341
"420","6343001","0473805886","www.ville-thiers.fr/Musee-de-la-Coutellerie","AUVERGNE-RHÔNE-ALPES","PUY DE DÔME",161471210,"Musée Municipal de la Coutellerie",NA,"Rue de la Coutellerie","63300","Thiers","France","fr","open",45.852432,3.54815385,17247,3848,21095,18343,3790,22133,19019,3896,22915,19344,4169,23513,21026,3486,24512,19964,4243,24207
"421","4101801","0254903333","www.chateaudeblois.fr","CENTRE-VAL DE LOIRE","LOIR ET CHER",7170311044,"Château Musées de Blois",NA,"Petits Degrés du Château","41000","Blois","France","fr","open",47.5857788,1.3313739,282710,49674,332384,226326,36844,263170,220317,32326,252643,234906,36822,271728,234669,34834,269503,233630,36932,270562
"422","9403401","0141243224","www.ecomusee-valdebievre.fr","ÎLE-DE-France","VAL DE MARNE",7676712,"Ecomusée du Val de Bièvre",NA,NA,"41120","Monthou-sur-Bièvre","France","fr","open",47.4364694,1.3750271,0,4171,4171,0,8572,8572,0,9229,9229,0,8894,8894,0,10120,10120,0,10732,10732
"423","0600401","0492905420","www.antibes-juanlespins.com","PROVENCE-ALPES-CÔTE D'AZUR","ALPES-MARITIMES",68051130,"Musée Picasso",NA,"Place Mariejol","06600","Antibes","France","fr","open",43.58070895,7.12825961788498,71844,42985,114829,84208,38980,123188,80818,39859,120677,97365,43719,141084,113493,44483,157976,85728,43366,129094
"424","1302801","0442714099","www.museeciotaden.org","PROVENCE-ALPES-CÔTE D'AZUR","BOUCHES DU RHONE",76026764,"Musée Ciotaden",NA,"Place Baragnon","13260","Cassis","France","fr","open",43.21439515,5.53995066521599,1621,1864,3485,2252,3611,5863,2775,3234,6009,2063,4092,6155,1684,3438,5122,2980,3106,6086
"425","8413801","0490355875","www.vaucluse.fr/culture-patrimoine/les-musees-departementaux/le-musee-du-cartonnage-et-de-limprimerie/","PROVENCE-ALPES-CÔTE D'AZUR","VAUCLUSE",1936611150,"Musée Départemental du Cartonnage et de l'Imprimerie",NA,"Avenue Maréchal Foch","84600","Valréas","France","fr","open",44.382611,4.987426,2367,1822,4189,2857,1796,4653,3656,940,4596,3982,1497,5479,2604,1696,4300,2275,1753,4028
"426","2209301","0296311999","www.musee-meheut.fr","BRETAGNE","COTES D'ARMOR",123094895,"Musée Mathurin Meheut",NA,"Rue du Docteur Calmette","22400","Saint-Brieuc","France","fr","open",48.469658,-2.51542680594679,6417,917,7334,6290,1020,7310,6119,1072,7191,7731,1430,9161,7613,1256,8869,4232,1008,5240
"427","8902501","0386340319","www.museeavallonnais.fr- site des musées de Bourgogne - site ville","BOURGOGNE-FRANCHE-COMTE","YONNE",3050054378,"Musée de l'Avallonnais Jean Després","5","Rue du Collège","89200","Avallon","France","fr","open",47.4869881,3.9065509,3046,1028,4074,655,3876,4531,965,2766,3731,730,2864,3594,978,3083,4061,1144,3045,4189
"428","2142501","0380925042","http://www.montbard.com/ ou Site des musées de Bourgogne","BOURGOGNE-FRANCHE-COMTE","CÔTE D’OR",702303764,"Musée Buffon",NA,"Rue du Parc Buffon","21500","Montbard","France","fr","open",47.6255801,4.3367165,461,8942,9403,3704,5146,8850,0,7688,7688,0,8569,8569,0,11256,11256,0,9623,9623
"429","6912302","0478384200","www.mtmad.fr","AUVERGNE-RHÔNE-ALPES","RHÔNE",440270631,"Musée des Arts Décoratifs",NA,"Autoroute du Soleil","69002","Lyon","France","fr","open",45.7326778,4.81816069263867,0,0,0,0,0,0,0,0,0,0,0,0,0,0,0,0,0,0
"430","3216001","0562073001","site du département : www.gers-gascogne.com","OCCITANIE","GERS",43270337,"Musée Campanaire",NA,"Place de l'Hôtel de Ville","32600","L'Isle-Jourdain","France","fr","open",43.6130002,1.08213319839728,8034,0,8034,9762,0,9762,4919,0,4919,3371,1260,4631,11378,0,11378,6420,0,6420
"431","3033401","0466224023","http://uzesmusee.blogspot.com ou http://www.uzes-tourisme.com/sitefr/musees/borias.htm","OCCITANIE","GARD",2910313011,"Musée Municipal Georges Borias",NA,"Promendade Racine","30700","Uzès","France","fr","open",44.0124548,4.422769,1394,1996,3390,1408,1373,2781,1374,972,2346,1506,1151,2657,1437,1267,2704,1831,1356,3187
"432","7012201","0384678200","http://musees.cg70.fr","BOURGOGNE-FRANCHE-COMTE","HAUTE-SAONE",87526037,"Musée Départemental Albert-et-Félicie Demard - ATP",NA,"Place de la Mairie","70600","Champlitte","France","fr","open",47.61684495,5.51422824864682,4962,7205,12167,4830,5712,10542,3737,7526,11263,7300,3380,10680,6280,4889,11169,6627,5308,11935
"433","6938701","0472739900","www.chrd.lyon.fr","AUVERGNE-RHÔNE-ALPES","RHÔNE",26131828,"Centre d'Histoire de la Résistance et de la Déportation",NA,"Rue Étienne Rognon","69007","Lyon","France","fr","open",45.7464306,4.8359519,21080,39843,60923,20999,43431,64430,25889,34046,59935,17870,35209,53079,42825,39992,82817,22034,42084,64118
"434","6806603","0389419060","www.musee-bartholdi.fr","GRAND EST","HAUT-RHIN",47576073,"Musée Bartholdi","30","Rue des Marchands","68000","Colmar","France","fr","open",48.0766092,7.35748216373478,17045,8218,25263,15235,7880,23115,13737,9052,22789,13573,7449,21022,12006,6429,18435,11458,4817,16275
"435","6833401","0389385325","www.ville-thann.fr - http://www.genealogiethaznn.org","GRAND EST","HAUT-RHIN",218472174,"Musée des Amis de Thann",NA,"Rue du Parc","68470","Husseren-Wesserling","France","fr","open",47.885102,6.9962639863085,466,1360,1826,397,894,1291,485,1222,1707,382,1683,2065,1143,851,1994,597,1325,1922
"436","5913501","0359734560","http://museedeflandre.lenord.fr/fr/Accueil.aspx","HAUTS-DE-France","NORD",5918815893,"Musée Départemental de Flandre",NA,"Grand Place","59670","Cassel","France","fr","open",50.7996394,2.4862076,28900,15628,44528,35332,15684,51016,33581,16203,49784,39275,14076,53351,36921,7766,44687,27085,22941,50026
"437","5927301","0328518100","www.gravelines-musee-estampe.fr","HAUTS-DE-France","NORD",178161634,"Musée du Dessin et de l'Estampe Originale",NA,"Allée des Marronniers","59820","Gravelines","France","fr","open",50.986066,2.12348824231678,2360,7011,9371,3094,6627,9721,1331,10967,12298,780,13183,13963,1669,10425,12094,2822,16541,19363
"438","8109101","0563740549","www.mprl.fr et www.musees-midi-pyrenees.fr","OCCITANIE","TARN",379420307,"Musée du Protestantisme de la Réforme à la Laïcité",NA,"D 53","81260","Castres","France","fr","open",43.661023,2.44914564857143,2754,895,3649,2396,1620,4016,2011,1287,3298,2184,1366,3550,2251,777,3028,2831,1190,4021
"439","8207501","0563028306","www.museecalbet.com","OCCITANIE","TARN-ET-GARONNE",89104903,"Musée Théodore Calbet","15","Rue Jean de Comère","82170","Grisolles","France","fr","open",43.827752,1.29470974019608,0,2548,2548,0,3043,3043,0,2827,2827,0,2737,2737,0,1645,1645,0,5061,5061
"440","0311801","0470902378","http://tourisme-bassin-gannat.com","AUVERGNE-RHÔNE-ALPES","ALLIER",387245355,"Musée Municipal de Gannat",NA,"Esplanade Pierre-Roch-Jurien-de-la-Gravière","03800","Gannat","France","fr","open",46.10151045,3.19655221516807,609,604,1213,722,2589,3311,610,2093,2703,604,918,1522,521,549,1070,401,1003,1404
"441","6211901","0321684074","Site de la ville","HAUTS-DE-France","PAS-DE-CALAIS",8264025342,"Musée Régional d'Ethnologie","457","Cours Promenade Kennedy","62700","Bruay-la-Buissière","France","fr","open",50.4787367,2.5372076,0,4766,4766,0,1980,1980,0,3999,3999,0,3890,3890,0,4858,4858,0,1620,1620
"442","3306301","0556008150","www.capc-bordeaux.fr ou www.bordeaux.fr","NOUVELLE-AQUITAINE","GIRONDE",117456213,"CAPC Musée d'Art Contemporain de Bordeaux",NA,"Rue Foy","33000","Bordeaux","France","fr","open",44.84864035,-0.572157106249999,43632,68615,112247,42761,54351,97112,40018,40507,80525,45846,53283,99129,44565,82736,127301,34840,104471,139311
"443","7027901","0384656910","/www.musee-baronmartin.fr","BOURGOGNE-FRANCHE-COMTE","HAUTE-SAONE",7508378482,"Musée Baron Martin",NA,"Tertre du Château","70100","Gray","France","fr","open",47.4464565,5.5938421,1514,2094,3608,2260,3207,5467,2301,2242,4543,2593,2610,5203,3443,3175,6618,3548,2658,6206
"444","7101402","0385542160","www.autun.com ou Site des musées de Bourgogne","BOURGOGNE-FRANCHE-COMTE","SAONE ET LOIRE",2380355755,"Musée Rolin",NA,"Place Saint-Louis","71400","Autun","France","fr","open",46.9456553,4.2993665,10818,8914,19732,11172,7032,18204,8335,5952,14287,9422,5316,14738,14709,6659,21368,10763,7463,18226
"445","1300403","0490493758","www.museereattu.arles.fr","PROVENCE-ALPES-CÔTE D'AZUR","BOUCHES DU RHONE",1451755,"Musée Réattu","12","Rue du Grand Prieuré","13200","Arles","France","fr","open",43.67927215,4.62750018227307,12974,17410,30384,8251,28865,37116,10673,50232,60905,13432,49640,63072,17289,41284,58573,25956,16045,42001
"446","1730002","0546414650","www.alienor.org","NOUVELLE-AQUITAINE","CHARENTE-MARITIME",2403784182,"Musée du Nouveau Monde",NA,"Rue Fleuriau","17000","La Rochelle","France","fr","open",46.161682,-1.1515984,6972,14394,21366,5696,12396,18092,5635,11471,17106,5723,12675,18398,4950,12728,17678,4737,10681,15418
"447","4028601","0558791300","www.museesamadet.landes.fr","NOUVELLE-AQUITAINE","LANDES",5681725229,"Musée Départemental de la Faïence et des Arts de la table",NA,"Route d'Hagetmau","40320","Samadet","France","fr","open",43.6412514,-0.5106808,3597,1146,4743,2406,2351,4757,2104,3542,5646,2953,1867,4820,2550,2502,5052,3126,2195,5321
"448","3430101","0499047616","http://museepaulvalery-sete.fr/","OCCITANIE","HERAULT",2244412926,"Musée Paul Valéry",NA,"Rue François Desnoyer","34200","Sète","France","fr","open",43.3953827,3.6906637,42844,7444,50288,40483,9183,49666,39884,10520,50404,59449,15342,74791,93926,6756,100682,52325,19038,71363
"449","2614601","0475918357","http://chateaux.ladrome.fr","AUVERGNE-RHÔNE-ALPES","DRÔME",133910375,"Château de Grignan",NA,"Rue Montant au Château","26230","Grignan","France","fr","open",44.4187586,4.9089195690003,119785,23653,143438,117440,30093,147533,113157,71736,184893,110552,71042,181594,99745,72584,172329,101488,69373,170861
"450","2543401","0381622330","http://www.musee-courbet.fr","BOURGOGNE-FRANCHE-COMTE","DOUBS",87617807,"Musée-Maison Natale Gustave Courbet","1","Rue de la Froidière","25290","Ornans","France","fr","open",47.1050435,6.14776317962545,21820,16365,38185,21911,13297,35208,39929,12046,51975,30606,17747,48353,45373,21469,66842,49772,34093,83865
"451","2227801","0296625520","www.mairie-saint-brieuc.fr","BRETAGNE","COTES D'ARMOR",78123314,"Musée d'Art et d'Histoire",NA,"Cour Francis Renaud","22000","Saint-Brieuc","France","fr","open",48.51234775,-2.76190369824988,0,24195,24195,0,28501,28501,0,16339,16339,0,23837,23837,0,27473,27473,0,33854,33854
"452","5439502","0383329997","www.man.uhp-nancy.fr","GRAND EST","MEURTHE ET MOSELLE",64003170,"Muséum- Aquarium de Nancy",NA,"Rue Sainte-Catherine","54100","Nancy","France","fr","open",48.6947248,6.1879398749197,32219,68617,100836,38077,68808,106885,30964,60123,91087,26906,61772,88678,28086,60259,88345,32243,70457,102700
"453","5427401","0383152770","www.grand-nancy.org","GRAND EST","MEURTHE ET MOSELLE",99542401,"Musée de l'Histoire du Fer",NA,"Avenue Général de Gaulle","54140","Jarville-la-Malgrange","France","fr","open",48.6665075,6.20871347159091,6125,13634,19759,3537,4440,7977,4000,5287,9287,3534,6564,10098,4007,7900,11907,8401,14007,22408
"454","3018901","0466767345","site de la ville - www.nimes.fr","OCCITANIE","GARD",1754343,"Musée d'Histoire Naturelle et de Préhistoire",NA,"Rue de la Grille","30300","Beaucaire","France","fr","open",43.8071045,4.64585740926791,0,28360,28360,2448,36142,38590,10387,29208,39595,0,35716,35716,1423,35871,37294,0,53809,53809
"455","0608802","0493911910","http://www.nice.fr/mairie_nice_1489.html","PROVENCE-ALPES-CÔTE D'AZUR","ALPES-MARITIMES",2264574278,"Musée d'Art et d'Histoire",NA,"Fossés de la Citadelle","06230","Villefranche-sur-Mer","France","fr","open",43.701601,7.3106059,32076,45189,77265,19759,33776,53535,18652,31758,50410,20070,26335,46405,0,51063,51063,24055,52781,76836
"456","1305601","0442413960","www-martigues.fr","PROVENCE-ALPES-CÔTE D'AZUR","BOUCHES DU RHONE",99114044,"Musée Ziem",NA,"Boulevard du 14 Juillet","13500","Martigues","France","fr","open",43.40867585,5.05421876402732,0,14069,14069,0,14348,14348,0,14029,14029,0,15149,15149,0,10775,10775,14083,9661,23744
"457","1320401","0491145930","www.marseille.fr","PROVENCE-ALPES-CÔTE D'AZUR","BOUCHES DU RHONE",68976388,"Musée des Beaux-Arts de Marseille",NA,"Rue Édouard Stéphan","13004","Marseille","France","fr","open",43.30459645,5.39403959608706,12525,27929,40454,15384,31163,46547,12330,17075,29405,11265,25112,36377,17163,43313,60476,183207,36793,220000
"458","4523403","0238792155","Région : www.musees.regioncentre.fr ou  www.orleans.fr (rubrique culture/musee)","CENTRE-VAL DE LOIRE","LOIRET",152119467,"Musée des Beaux-Arts","1","Rue Fernand Rabier","45000","Orléans","France","fr","open",47.90265,1.90976669421488,33816,15418,49234,12352,50976,63328,9462,47960,57422,8115,42568,50683,7483,44056,51539,6955,55716,62671
"459","2901901","0298008797","www.musee-brest.com","BRETAGNE","FINISTERE",730880579,"Musée des Beaux-Arts de Brest","24","Rue Traverse","29200","Brest","France","fr","open",48.38506775,-4.49017607519185,4617,12407,17024,4149,14149,18298,4660,14323,18983,7690,15762,23452,5797,16067,21864,7847,18498,26345
"460","2819601","0237243097","http://perso.orange.fr/marcelproust/","CENTRE-VAL DE LOIRE","EURE ET LOIR",2288529939,"Musée Marcel Proust",NA,"Rue des Trois Maries","28120","Illiers-Combray","France","fr","open",48.2996594,1.2430508,3693,348,4041,4414,174,4588,3915,286,4201,3923,923,4846,4363,326,4689,4958,574,5532
"461","1803302","0248578117","Site de la ville www.ville-bourges.fr","CENTRE-VAL DE LOIRE","CHER",64598357,"Musée des Arts Décoratifs",NA,"Rue de l'Hôtel Lallemant","18000","Bourges","France","fr","open",47.0850865,2.39830163875441,0,0,0,4603,2650,7253,0,12471,12471,0,11017,11017,0,18628,18628,0,21582,21582
"462","6226801","0321832323","www.musee-ceramique-desvres.com","HAUTS-DE-France","PAS-DE-CALAIS",244679581,"Musée de la Céramique",NA,"Rue Jean Macé","62240","Desvres","France","fr","open",50.666714,1.84206815982028,6981,1583,8564,7478,1397,8875,6908,1194,8102,7295,2371,9666,7188,1356,8544,7001,710,7711
"463","9207101","0141872950","http://domaine-de-sceaux.hauts-de-seine.fr/","ÎLE-DE-France","HAUTS DE SEINE",1620203330,"Musée du Domaine Départemental de Sceaux",NA,"Allée de la Duchesse","92330","Sceaux","France","fr","open",48.7742577,2.300099,12397,11584,23981,20912,14376,35288,20844,13946,34790,14678,14260,28938,21421,21632,43053,16132,17388,33520
"464","7835601","0139307272","http://www.port-royal-des-champs.eu","ÎLE-DE-France","YVELINES",823061902,"Musée National de Port Royal des Champs",NA,"Route Forestière de Font Couverte","78114","Trappes","France","fr","open",48.7479939,2.0152509,4938,28871,33809,6170,18975,25145,6689,15920,22609,4983,19161,24144,4791,20816,25607,4062,15436,19498
"465","7635103","0235422790","Site de la ville : www.ville-lehavre.fr","NORMANDIE","SEINE-MARITIME",76087045,"Musée de l'Hôtel Dubocage de Bléville",NA,"Rue de l'Abbaye","76600","Le Havre","France","fr","open",49.5032922,0.165297007974925,0,8134,8134,0,11224,11224,0,6420,6420,0,11779,11779,0,8599,8599,0,8080,8080
"466","0606901","0493365298","www.museesdegrasse.fr","PROVENCE-ALPES-CÔTE D'AZUR","ALPES-MARITIMES",67332571,"Villa-Musée Jean-Honoré Fragonard",NA,"Impasse Fragonard","06130","Grasse","France","fr","open",43.65664265,6.92114948884346,0,2332,2332,0,1901,1901,0,1749,1749,0,7695,7695,0,144,144,0,5931,5931
"467","4125801","0254714020","www.musees.regioncentre","CENTRE-VAL DE LOIRE","LOIR ET CHER",1241279063,"Musée Archéologique",NA,"Allée de la Mairie","41140","Thésée","France","fr","open",47.3280766,1.3062994,870,0,870,577,80,657,629,99,728,877,95,972,428,84,512,738,211,949
"468","0602902","0493385526","Site de la ville","PROVENCE-ALPES-CÔTE D'AZUR","ALPES-MARITIMES",2824215844,"Musée de la Mer",NA,"Allée des Eucalyptus","06407","Cannes","France","fr","open",43.523904,7.0453202,41397,33508,74905,45690,34837,80527,41654,35794,77448,45059,37823,82882,47990,38898,86888,44519,35981,80500
"469","8830401","0329378159","www.musee-lutherie-mirecourt.fr","GRAND EST","VOSGES",1371279463,"Musée de la Lutherie et de l'Archèterie Française",NA,"Cours Stanislas","88500","Mirecourt","France","fr","open",48.3015025,6.1356331,6133,3283,9416,5747,4469,10216,5482,3622,9104,5963,4027,9990,6674,5045,11719,7815,4216,12031
"470","0278901","0323582461","http://museedelathierache.jimdo.com ou www.evasion-aisne.com","HAUTS-DE-France","AISNE",3895217493,"Musée de La Thiérache","3","Rue du Traité de Paix","02140","Vervins","France","fr","open",49.8346266,3.9067889,0,5127,5127,0,6054,6054,0,7535,7535,0,8046,8046,0,5119,5119,0,3908,3908
"471","5951201","0320692360","www.roubaix-lapiscine.com","HAUTS-DE-France","NORD",799753358,"La Piscine - Musée d'Art et d'Industrie André Diligent de Roubaix",NA,"Rue Gustave Charpentier","59170","Croix","France","fr","open",50.67030335,3.17294593956463,63018,79985,143003,52546,138322,190868,107625,109032,216657,164578,78106,242684,124728,79091,203819,88501,104042,192543
"472","1474701","0231711020","Site du conseil général","NORMANDIE","CALVADOS",289750553,"Musée et Sites archéologiques de Vieux-la-Romaine","13","Chemin Haussé dit du Duc Guillaume","14930","Vieux","France","fr","open",49.1063245,-0.429699117007308,6245,17558,23803,9167,11009,20176,11399,5933,17332,11695,6205,17900,10594,8051,18645,10362,6359,16721
"473","1411801","0231304770","www.mba.caen.fr","NORMANDIE","CALVADOS",315032925,"Musée des Beaux-Arts",NA,"Chemin des Fossés du Château","14000","Caen","France","fr","open",49.1862879,-0.3615817,16775,50333,67108,26209,47030,73239,51458,73927,125385,21583,41075,62658,20352,34056,54408,102162,64354,166516
"474","3528801","0299407116","Site de la ville - www.ville-saint-malo.fr","BRETAGNE","ILE ET VILAINE",3275333600,"Musée International du Long-Cours Cap-Hornier",NA,"Cale Solidor","35400","Saint-Malo","France","fr","open",48.6340431,-2.0260137,7764,7061,14825,7946,8284,16230,6809,5114,11923,8242,6017,14259,6620,5065,11685,7191,4583,11774
"475","6748206","0388525000","www.musees-strasbourg.eu","GRAND EST","BAS-RHIN",491674514,"Musée de l'Œuvre Notre-Dame",NA,"Rue du Dévidoir","67065","Strasbourg","France","fr","open",48.5808482,7.75124240154725,19856,32103,51959,19102,28443,47545,21165,26695,47860,17310,21318,38628,10183,28091,38274,15657,22897,38554
"476","0407001","0492314529","www.musee-gassendi.org","PROVENCE-ALPES-CÔTE D'AZUR","ALPES DE HAUTE PROVENCE",570290612,"Musée Gassendi","64","Boulevard Gassendi","04000","Digne-les-Bains","France","fr","open",44.09366125,6.23840660373135,3335,12724,16059,3170,15470,18640,2206,16493,18699,2721,16483,19204,1631,10784,12415,2776,8189,10965
"477","8902402","0386180550","Site des musées de Bourgogne","BOURGOGNE-FRANCHE-COMTE","YONNE",62636018,"Musée d'Art et d'Histoire",NA,"Rue Cochois","89000","Auxerre","France","fr","open",47.8005184,3.57251569011661,0,31269,31269,0,29251,29251,0,27043,27043,0,37017,37017,0,43185,43185,7576,25528,33104
"478","1038706","0325762680","www.musees-troyes.com","GRAND EST","AUBE",73124719,"Musée d'Art Moderne",NA,"Rue de la Crosse","10000","Troyes","France","fr","open",48.29995,4.08229134200517,8359,687,9046,19568,27324,46892,10276,21176,31452,12046,20326,32372,9668,32751,42419,6317,21377,27694
"479","3819001","0474951910","www.musee.larina-hieres.com ou Site du patrimoine en isère - www.patrimoine-en-isere.fr","AUVERGNE-RHÔNE-ALPES","ISERE",1869973658,"Maison du Patrimoine de Hières-sur-Amby",NA,"Montée de la Cure","38118","Hières-sur-Amby","France","fr","open",45.7970511,5.2932086,7598,1122,8720,6961,1412,8373,6907,2306,9213,6385,2122,8507,6253,1722,7975,7293,1231,8524
"480","2632401","0475047419","www.musat.fr","AUVERGNE-RHÔNE-ALPES","DRÔME",75706507,"Musée d'Archéologie Tricastine",NA,"Passage Fanjoux","26130","Saint-Paul-Trois-Châteaux","France","fr","open",44.34948825,4.76811397962614,2309,6286,8595,2150,6239,8389,3132,4789,7921,3330,4442,7772,3625,3152,6777,2111,3434,5545
"481","7646201","0235930655","site des musées de la région","NORMANDIE","SEINE-MARITIME",2151987864,"Musée Mathon-Durand",NA,"Grande Rue Saint-Pierre","76270","Neufchâtel-en-Bray","France","fr","open",49.7311219,1.4392934,934,881,1815,475,521,996,1127,834,1961,789,254,1043,612,755,1367,449,2376,2825
"482","1516801","0471234296","www.ecomuseedemargeride.fr","AUVERGNE-RHÔNE-ALPES","CANTAL",6838400485,"Ecomusée de Margeride-Haute-Auvergne",NA,NA,"15320","Ruynes-en-Margeride","France","fr","open",44.9961982,3.207524,5967,8342,14309,7986,1851,9837,9065,249,9314,5488,3321,8809,6958,635,7593,7460,1467,8927
"483","7415201","0450462302","www.chateaudemontrottier.com ou www.academie-florimontane.fr","AUVERGNE-RHÔNE-ALPES","HAUTE-SAVOIE",7049144505,"Musée Léon Marès",NA,"Allée du Château","74330","Lovagny","France","fr","open",45.8988203,6.0391237,29538,288,29826,22972,1053,24025,19259,0,19259,18500,0,18500,18481,0,18481,16393,0,16393
"484","0273801","0323579377","www.resistance-deportation-picardie.com - www.mrdp-picardie.com","HAUTS-DE-France","AISNE",173604154,"Musée de la Résistance et de la Déportation",NA,"Rue Gouillard Marcel","02700","Tergnier","France","fr","open",49.6585145,3.31585009830882,3378,700,4078,2085,1700,3785,3964,1650,5614,8842,10000,18842,20951,0,20951,22587,0,22587
"485","1601502","0545927343","www.musee-du-papier.fr","NOUVELLE-AQUITAINE","CHARENTE",44840732,"Atelier - Musée du Papier",NA,"Rue de Bordeaux","16000","Saint-Cybard","France","fr","open",45.65355635,0.149532541772716,4206,13938,18144,11746,20540,32286,3438,13034,16472,0,23353,23353,590,20762,21352,902,19263,20165
"486","3018905","0466767191","www.nimes.fr","OCCITANIE","GARD",41832267,"Musée des Beaux-Arts",NA,"Rue de la Cité Foulc","30033","Nîmes","France","fr","open",43.83194295,4.3605864848234,5799,8067,13866,0,17085,17085,146,14759,14905,1049,12317,13366,894,14274,15168,3264,12886,16150
"487","6528601","0562423737","www.chateaufort-lourdes.fr ou site de la ville - http://www.lourdes-visite.com/","OCCITANIE","HAUTES-PYRENEES",4716535332,"Musée Pyrénéen","25","Rue du Fort","65100","Lourdes","France","fr","open",43.096493,-0.0490182,68877,10465,79342,69555,9244,78799,65584,8232,73816,63516,8605,72121,66101,7708,73809,60813,8179,68992
"488","8403103","0490630492","Site de la ville","PROVENCE-ALPES-CÔTE D'AZUR","VAUCLUSE",1802571381,"Musée Comtadin-Duplessis",NA,"Rue du Collège","84200","Carpentras","France","fr","open",44.054376,5.046289,0,3764,3764,10,142,152,639,1116,1755,602,3933,4535,441,2370,2811,372,2026,2398
"489","6748207","0388525000","www.musees-strasbourg.eu","GRAND EST","BAS-RHIN",22290183,"Musée Historique","2","Rue du Vieux Marché aux Poissons","67065","Strasbourg","France","fr","open",48.579946,7.75076798380218,33524,28427,61951,23448,34650,58098,23053,28418,51471,21653,27259,48912,20463,26785,47248,17194,18690,35884
"490","1501402","0471454610","www.ville-aurillac.fr","AUVERGNE-RHÔNE-ALPES","CANTAL",6580283562,"Musée d'Art et d'Archéologie",NA,"Rue des Carmes","15000","Aurillac","France","fr","open",44.9253069,2.4420708,1291,10947,12238,1448,15107,16555,961,19394,20355,1059,16303,17362,1773,19094,20867,1333,14747,16080
"491","3826901","0476309815","www.lamure.fr","AUVERGNE-RHÔNE-ALPES","ISERE",1654912102,"Musée Matheysin",NA,"Rue Colonel Escallon","38350","La Mure","France","fr","open",44.9046933,5.7845917,919,1230,2149,834,1275,2109,615,1621,2236,13349,1913,15262,505,1166,1671,663,1283,1946
"492","7510507",NA,"www.mnhn.fr","ÎLE-DE-France","PARIS",7444,"Galerie de Botanique (Muséum National National d'Histoire Naturelle)",NA,NA,NA,"Paris","France","fr","open",48.8566969,2.3514616,8036,2428,10464,6880,2185,9065,4736,3027,7763,3866,5896,9762,8069,9823,17892,2127,2043,4170
"493","1436601","0231620770","www.lintercom.fr","NORMANDIE","CALVADOS",130317028,"Musée d'Art et d'Histoire de Lisieux",NA,"Rue du Bon Ange","14100","Lisieux","France","fr","open",49.144569,0.219214115440378,149,7278,7427,188,4666,4854,148,5232,5380,89,4480,4569,157,5319,5476,23,3042,3065
"494","7932901","0549663697","www.ville-thouars.fr/vah/","NOUVELLE-AQUITAINE","DEUX-SEVRES",64211578,"Musée Henri Barré",NA,"Rue du Bac","79100","Thouars","France","fr","open",46.97362875,-0.21811853555866,401,1887,2288,534,2090,2624,427,1839,2266,177,1540,1717,401,1771,2172,386,2066,2452
"495","8311801","0494192575","www.musee-saintraphael.com","PROVENCE-ALPES-CÔTE D'AZUR","VAR",130473371,"Musée Archéologique",NA,"Rue de la Vieille Église","83700","Saint-Raphaël","France","fr","open",43.42600365,6.76924306596667,0,21000,21000,0,20000,20000,595,18559,19154,340,18630,18970,1881,18388,20269,0,28237,28237
"496","7733302","0164282742","Site de la ville - www.ville-nemours.fr","ÎLE-DE-France","SEINE ET MARNE",2177750355,"Château-musée de Nemours",NA,"Cours du Château","77140","Nemours","France","fr","open",48.2655865,2.6970907,5621,7127,12748,6279,5568,11847,4885,3378,8263,4280,5746,10026,4323,5781,10104,4629,3492,8121
"497","3201301","0562057479","www.musee-jacobins.auch.fr www.auch-tourisme.com ou site de la mairie","OCCITANIE","GERS",65470495,"Musée des Amériques",NA,"Rue Daumesnil","32000","Auch","France","fr","open",43.64730755,0.58759672603058,580,1015,1595,8196,5348,13544,5305,9567,14872,5466,12777,18243,5397,11167,16564,4463,11770,16233
"498","7127001","0385399038","http://www.macon.fr/Culture-sports-et-loisirs/Les-Musees-de-Macon","BOURGOGNE-FRANCHE-COMTE","SAONE ET LOIRE",700244362,"Musée des Ursulines",NA,"Rue des Ursulines","71000","Saint-Clément","France","fr","open",46.307027,4.83314219713088,2978,8399,11377,2620,20925,23545,2383,20951,23334,2272,21590,23862,2068,20028,22096,1974,20177,22151
"499","8936801","0386456195","www.musee-colette.com","BOURGOGNE-FRANCHE-COMTE","YONNE",2598935771,"Musée Colette",NA,"Place du Château","89520","Saint-Sauveur-en-Puisaye","France","fr","open",47.6173071,3.1989776,5777,1306,7083,7382,1264,8646,7816,230,8046,5148,1372,6520,4442,1590,6032,6121,1057,7178
"500","3854402","0474852035","www.musees-vienne.fr  - Site du patrimoine de l'Isère","AUVERGNE-RHÔNE-ALPES","ISERE",135880564,"Musée Lapidaire Saint-Pierre",NA,"Rue Delorme","38200","Vienne","France","fr","open",45.522843,4.87106072000001,3650,9429,13079,3369,7294,10663,3162,6416,9578,4607,7317,11924,6276,10998,17274,3766,7317,11083
"501","8109901","0563571825","Site de la ville www.ville-gaillac.fr","OCCITANIE","TARN",1794967910,"Musée des Beaux-Arts",NA,"Boulevard Foucault","81600","Gaillac","France","fr","open",43.8949812,1.8980683,16499,1241,17740,1208,3556,4764,2100,2776,4876,2588,3334,5922,1235,2325,3560,2907,1702,4609
"502","8519101","0251474835","site de la ville","PAYS DE LA LOIRE","VENDEE",86235738,"Musée Municipal",NA,"Rue Jean Jaurès","85000","La Roche-sur-Yon","France","fr","open",46.66976595,-1.4288346975641,0,21157,21157,0,11090,11090,0,15979,15979,0,11455,11455,0,14684,14684,0,13924,13924
"503","3818502","0457588901","www.musee-dauphinois.fr","AUVERGNE-RHÔNE-ALPES","ISERE",1102624,"Musée Dauphinois","30","Rue Maurice Gignoux","38031","Grenoble","France","fr","open",45.1951489,5.72707178855217,0,84194,84194,0,59665,59665,0,76413,76413,0,63492,63492,0,61002,61002,0,67630,67630
"504","2921701","0298061443","www.museepontaven.fr","BRETAGNE","FINISTERE",84081121,"Musée de Pont-Aven",NA,"Rue Louis Lomenech","29930","Pont-Aven","France","fr","open",47.8550965,-3.74640609003283,69795,24282,94077,89287,29330,118617,90363,32181,122544,408,5132,5540,316,7560,7876,393,5071,5464
"505","3523803","0299513815","www.ecomusee-rennes-metropole.fr","BRETAGNE","ILE ET VILAINE",178814913,"Ecomusée du Pays de Rennes",NA,"Route de Châtillon-Sur-Seiche","35230","Noyal-Châtillon-sur-Seiche","France","fr","open",48.07772335,-1.66635435664524,21212,35965,57177,20962,37062,58024,17432,40082,57514,15430,42757,58187,14326,42581,56907,14363,37050,51413
"506","5913601","0359733800","www.cg59.fr ou www.tourisme-lecateau.fr/museematisse","HAUTS-DE-France","NORD",75875248,"Musée Départemental Matisse",NA,"Rue Charles Seydoux","59360","Le Cateau-Cambrésis","France","fr","open",50.10631,3.54072612265883,38843,11541,50384,15161,37760,52921,15550,38410,53960,15649,38016,53665,43046,12118,55164,20804,41646,62450
"507","0602702","0493206107","www.cagnes-tourisme.com/renoir ou www.chez.com/renoir/cagnes.htm","PROVENCE-ALPES-CÔTE D'AZUR","ALPES-MARITIMES",63863191,"Musée Renoir",NA,"Chemin des Collettes","06800","Cagnes-sur-Mer","France","fr","open",43.6676737,7.15694825232139,22922,13968,36890,23370,14203,37573,24431,14609,39040,27051,15664,42715,33888,18931,52819,17152,11530,28682
"508","2538802","0381992261","www.montbeliard.fr","BOURGOGNE-FRANCHE-COMTE","DOUBS",7372375792,"Musée du Château des Ducs de Wurtemberg",NA,"Square Beurnier","25200","Montbéliard","France","fr","open",47.5098603,6.79769,4382,9685,14067,4956,11116,16072,6874,10843,17717,5600,8758,14358,5654,10883,16537,5442,12687,18129
"509","6733901","0388544807","www.betschdorf.fr/tourisme/visiter_betschdrof/musee_poterie.php","GRAND EST","BAS-RHIN",3451539391,"Musée de la Poterie","1-13","Rue du Terrain","67116","Reichstett","France","fr","open",48.6480723,7.7520884,1875,962,2837,2124,379,2503,2141,332,2473,2200,749,2949,2020,293,2313,1844,200,2044
"510","8100401","0563494870","www.musee-toulouse-lautrec.com","OCCITANIE","TARN",34627060,"Musée Toulouse Lautrec",NA,"Place de L'Archevêché","81000","Albi","France","fr","open",43.9293134,2.1428612931045,121652,30201,151853,135171,30766,165937,131178,32677,163855,138158,31712,169870,134230,33787,168017,150606,32872,183478
"511","5145401","0326353600","site de la ville","GRAND EST","MARNE",733881096,"Musée des Beaux-Arts de Saint-Denis",NA,NA,"51100","Reims","France","fr","open",49.2529815,4.03042708085769,47031,0,47031,18520,26502,45022,22947,21704,44651,18651,17887,36538,22782,24777,47559,21312,29699,51011
"512","7511801","0149258937","www.museedemontmartre.fr","ÎLE-DE-France","PARIS",154679327,"Musée de Montmartre",NA,"Rue Cortot","75018","Paris","France","fr","open",48.88824985,2.34067761429978,94596,12524,107120,98587,16048,114635,107161,8999,116160,90565,0,90565,75407,0,75407,81000,4000,85000
"513","3003201","0466599007","www.beaucaire.fr/spip.php?article65","OCCITANIE","GARD",1754343,"Musée Municipal de la Vignasse",NA,"Rue de la Grille","30300","Beaucaire","France","fr","open",43.8071045,4.64585740926791,1978,537,2515,587,1673,2260,418,1719,2137,1075,2015,3090,1692,3240,4932,1598,2673,4271
"514","0128301","0474819682","Site de la ville : www.ville-oyonnax.fr/culture/museepeigneetplast.php","AUVERGNE-RHÔNE-ALPES","AIN",1536396604,"Musée du Peigne et de la Plasturgie",NA,"Rue Capitaine Montreal","01100","Veyziat","France","fr","open",46.2607789,5.6465246,1509,2397,3906,1464,3085,4549,2136,2736,4872,2219,2308,4527,2408,2716,5124,1452,4097,5549
"515","1402101","0231223431","www.musee-arromanches.fr","NORMANDIE","CALVADOS",128118203,"Musée du Débarquement",NA,"Cale Maréchal Montgomery","14117","Arromanches-les-Bains","France","fr","open",49.3402288,-0.620497970755188,286653,12948,299601,277857,12953,290810,268915,10885,279800,300540,12324,312864,335258,15303,350561,286417,11835,298252
"516","1741503","0546742097","www.alienor.org","NOUVELLE-AQUITAINE","CHARENTE-MARITIME",67102698,"Musée Archéologique",NA,"Place Bassompierre","17100","Saintes","France","fr","open",45.7452577,-0.628659715838041,510,3335,3845,582,3746,4328,964,4641,5605,52,29125,29177,0,31949,31949,0,41081,41081
"517","4004601","0558780065","www.hydravions-biscarrosse.com","NOUVELLE-AQUITAINE","LANDES",1508590127,"Musée Historique de l'Hydravion",NA,"Rue Louis Bréguet","40600","Biscarrosse","France","fr","open",44.3892176,-1.1816658,16589,2703,19292,16112,2596,18708,15455,2925,18380,17081,1943,19024,14421,1800,16221,14414,609,15023
"518","2901902","0298221239","www.musee-marine.fr/brest","BRETAGNE","FINISTERE",5882540291,"Musée National de la Marine",NA,"Rue Franklin Roosevelt","29200","Brest","France","fr","open",48.381272,-4.4923642,37252,36823,74075,36589,37887,74476,31119,39232,70351,33172,37927,71099,28916,33485,62401,31336,37991,69327
"519","3536002","0299750454","site de l'office du tourisme","BRETAGNE","ILE ET VILAINE",92884430,"Musée du Château de Vitré",NA,"Rue du Rachapt","35500","Vitré","France","fr","open",48.1260135,-1.21669925291054,17597,4321,21918,15572,4817,20389,15495,6961,22456,16613,4240,20853,15339,6828,22167,16010,7336,23346
"520","4101805","0254742100","www.ville-blois.fr","CENTRE-VAL DE LOIRE","LOIR ET CHER",273622,"Muséum d'Histoire Naturelle",NA,NA,"41000","Blois","France","fr","open",47.5876861,1.3337639,6970,8464,15434,5769,5963,11732,6467,7636,14103,5671,6334,12005,6737,6664,13401,5998,7684,13682
"521","0600402","0493958598","www.antibes-juanslespins.com/fr/culture/musees","PROVENCE-ALPES-CÔTE D'AZUR","ALPES-MARITIMES",68051130,"Musée d'Histoire et d'Archéologie",NA,"Place Mariejol","06600","Antibes","France","fr","open",43.58070895,7.12825961788498,5729,3359,9088,5412,6175,11587,4996,5571,10567,4988,4872,9860,5068,4261,9329,4173,4444,8617
"522","4610201","0565340625","http://www.musee-champollion.fr/","OCCITANIE","LOT",4383203115,"Musée d'Histoire de Figeac",NA,"Boulevard du Colonel Teulié","46100","Figeac","France","fr","open",44.6105203,2.0363635,347,608,955,470,449,919,368,350,718,0,0,0,0,0,0,347,615,962
"523","2146401","0380620137","Site des musées de Bourgogne","BOURGOGNE-FRANCHE-COMTE","CÔTE D’OR",4737197736,"Musée Municipal",NA,"Rue Camille Rodier","21700","Nuits-Saint-Georges","France","fr","open",47.1386701,4.9505695,390,5124,5514,589,4238,4827,204,3603,3807,0,3277,3277,104,2975,3079,406,2421,2827
"524","3851601","0476429735","www.musee-hebert.fr","AUVERGNE-RHÔNE-ALPES","ISERE",192104327,"Musée Hébert",NA,"Musée Hébert","38700","La Tronche","France","fr","open",45.2057094,5.7489167,1418,27952,29370,0,40151,40151,0,36092,36092,0,26689,26689,0,27286,27286,0,32545,32545
"525","1433301","0231891412","Site de la ville","NORMANDIE","CALVADOS",7179675885,"Musée d'Ethnographie et d'Arts Populaires et Musée de la Marine",NA,"Rue de la Prison","14600","Honfleur","France","fr","open",49.4196131,0.233695,12360,10908,23268,17750,5756,23506,14228,1002,15230,17626,1290,18916,17851,244,18095,16623,1029,17652
"526","4012001","0558730389","www.arthous.landes.org","NOUVELLE-AQUITAINE","LANDES",250016053,"Musée Départemental d'Histoire et d'Archéologie",NA,"Route de l'Abbaye","40300","Hastingues","France","fr","open",43.527247,-1.12206837379295,4764,3075,7839,6110,2804,8914,5393,7034,12427,4759,5798,10557,5149,5266,10415,4802,5537,10339
"527","8106502","0563624183","http://www.ville-castres.fr/centre-national-et-musee-jean-jaures-presentation","OCCITANIE","TARN",83184155,"Musée Jean Jaurès","2","Place Pélisson","81100","Castres","France","fr","open",43.607194,2.24049644577562,2550,12677,15227,2665,6890,9555,2358,4931,7289,2480,9886,12366,3897,9400,13297,2797,8962,11759
"528","3904101","0384873300",NA,"BOURGOGNE-FRANCHE-COMTE","JURA",121580330,"Musée de l'Artisanat Jurassien",NA,"Rue de l'Abbaye","39210","Château-Chalon","France","fr","open",46.753866,5.62429573189033,0,19000,19000,0,16000,16000,0,15664,15664,0,22672,22672,0,17771,17771,0,18559,18559
"529","2538801","0381992261","www.montbeliard.fr","BOURGOGNE-FRANCHE-COMTE","DOUBS",7372375792,"Musée Beurnier-Rossel",NA,"Square Beurnier","25200","Montbéliard","France","fr","open",47.5098603,6.79769,456,2009,2465,499,2934,3433,1134,2859,3993,2024,3037,5061,2195,3234,5429,961,3643,4604
"530","9004101","0384546041","www.musees-des-techniques.org ou www.ccvosgesdusud.fr","BOURGOGNE-FRANCHE-COMTE","TERRITOIRE DE BELFORT",2647243377,"Forge-Musée",NA,"Rue de Rougemont","90170","Étueffont","France","fr","open",47.7224462,6.920875,391,716,1107,573,440,1013,448,898,1346,633,366,999,816,1079,1895,857,1179,2036
"531","4221801","0477795252","www.mam-st-etienne.fr/","AUVERGNE-RHÔNE-ALPES","LOIRE",244953708,"Musée d'Art Moderne et Contemporain de Saint-Etienne Métropole",NA,"A 72","42270","Saint-Priest-en-Jarez","France","fr","open",45.4694622,4.3742124,29735,30927,60662,29914,36629,66543,28822,27863,56685,53749,0,53749,28487,26178,54665,34770,37641,72411
"532","1803301","0248247538","Site de la ville : www.ville-bourges.fr","CENTRE-VAL DE LOIRE","CHER",3639383770,"Musée Estève",NA,"Rue Édouard Branly","18000","Bourges","France","fr","open",47.0861911,2.396213,0,0,0,6779,2238,9017,0,14181,14181,0,15257,15257,0,15725,15725,0,13742,13742
"533","8816002","0329814830","www.museedelimage.fr","GRAND EST","VOSGES",7012693985,"Musée de l'Image","42","Quai de Dogneville","88000","Épinal","France","fr","open",48.1838682,6.446526,12469,1765,14234,14032,2247,16279,18512,4577,23089,21151,3541,24692,22282,4389,26671,21067,6940,28007
"534","7510304","0153018200","www.arts-et-metiers.net","ÎLE-DE-France","PARIS",247618453,"Musée des Arts et Métiers",NA,"Rue Réaumur","75003","Paris","France","fr","open",48.8660977,2.3554138,59165,129934,189099,98987,134688,233675,77225,128544,205769,82367,143731,226098,89424,153455,242879,134156,155230,289386
"535","9204801","0146238713","www.meudon.fr","ÎLE-DE-France","HAUTS DE SEINE",137829073,"Musée d'Art et d'Histoire","11","Rue des Pierres","92190","Meudon","France","fr","open",48.806285,2.23509117024648,3381,10795,14176,3501,10000,13501,2536,8939,11475,9457,0,9457,2115,7958,10073,3318,7063,10381
"536","5050201","0233725255",NA,"NORMANDIE","MANCHE",3446879240,"Musée des Beaux-Arts",NA,"Place du Champ de Mars","50000","Saint-Lô","France","fr","open",49.1170485,-1.0881118,1754,8338,10092,1611,8236,9847,1790,6734,8524,1484,5947,7431,7229,0,7229,9077,0,9077
"537","1305505","0491553600","www.mairie-marseille.fr ou http://musee-histoire-marseille-voie-historique.fr/","PROVENCE-ALPES-CÔTE D'AZUR","BOUCHES DU RHONE",2499522058,"Musée d'Histoire de Marseille",NA,"Square Belsunce","13001","Marseille","France","fr","open",43.2975573,5.3756864,25790,41839,67629,26084,47782,73866,22100,65596,87696,21890,51353,73243,21924,69905,91829,17550,62729,80279
"538","2505602","0381878161","www.besancon.fr/museedutemps","BOURGOGNE-FRANCHE-COMTE","DOUBS",53757083,"Musée du Temps",NA,"Rue Victor Hugo","25000","Besançon","France","fr","open",47.2346134,6.02903556195004,8081,32326,40407,8847,30001,38848,8055,29993,38048,7272,35433,42705,8029,32118,40147,5026,33934,38960
"539","7300801","0479610657","Site de la ville - www.aixlesbains.fr","AUVERGNE-RHÔNE-ALPES","SAVOIE",79376440,"Musée du docteur Faure",NA,"Boulevard des Côtes","73100","Aix-les-Bains","France","fr","open",45.6925521,5.91590681502264,6712,6446,13158,8704,7489,16193,6453,6002,12455,5621,5080,10701,5848,4463,10311,5894,5453,11347
"540","5603401","0297522204","www.museedecarnac.com","BRETAGNE","MORBIHAN",93998149,"Musée de Préhistoire J. Miln- Z. Le-Rouzic","10","Place de la Chapelle","56340","Carnac","France","fr","open",47.584819,-3.07829843827751,28439,5894,34333,31907,5899,37806,28306,6199,34505,29576,10007,39583,28647,6409,35056,26107,5730,31837
"541","3818503","0476440535","http://www.grenoble.fr/639-museum-de-grenoble.htm","AUVERGNE-RHÔNE-ALPES","ISERE",35095625,"Muséum d'Histoire Naturelle de Grenoble","1","Rue Dolomieu","38000","Grenoble","France","fr","open",45.18801185,5.73520909178722,20799,84025,104824,12099,59669,71768,26733,67334,94067,30345,61450,91795,35942,66125,102067,12696,56321,69017
"542","4909904","0241752550","www.museedutextile.com ou www.ville-cholet.fr/musee-textile.php","PAYS DE LA LOIRE","MAINE-ET-LOIRE",1301987143,"Musée du Textile",NA,"Avenue Marcel Cauchy","49300","Cholet","France","fr","open",47.0681455,-0.8982604,5406,8373,13779,4840,7827,12667,5180,6356,11536,5020,7711,12731,5048,6368,11416,5801,6563,12364
"543","7919103","0549787200","www.alienor.org","NOUVELLE-AQUITAINE","DEUX-SEVRES",795257552,"Musée ethnographique et archéologique du Donjon","26","Avenue de Limoges","79000","Niort","France","fr","open",46.3210536,-0.454416,9006,9733,18739,10029,9744,19773,7988,9018,17006,8500,9500,18000,9564,9403,18967,9030,8140,17170
"544","1716801","0546841523","http://musee.fouras.assoc.pagespro-orange.fr/","NOUVELLE-AQUITAINE","CHARENTE-MARITIME",92529363,"Musée Régional de Fouras",NA,"Place Vauban","17450","Fouras","France","fr","open",45.986004,-1.0975170518659,7669,1698,9367,8001,1560,9561,6924,1586,8510,6669,1451,8120,6857,3707,10564,6145,1184,7329
"545","4811601","0466458073","www.cevennes-parcnational.fr","OCCITANIE","LOZERE",614381321,"Ecomusée du Mont Lozère",NA,"D 20","48220","Florac","France","fr","open",44.3655806,3.7463973,0,850,850,1198,1430,2628,1926,1518,3444,2369,2111,4480,2324,1967,4291,3633,477,4110
"546","9206301","0141290555","www.chateau-malmaison.fr","ÎLE-DE-France","HAUTS DE SEINE",2703428029,"Musée National des Châteaux de Malmaison et de Bois-Préau",NA,"Avenue du Château de la Malmaison","92500","Rueil-Malmaison","France","fr","open",48.8737321,2.1687097,48873,32372,81245,46311,38827,85138,38756,28614,67370,47974,36143,84117,58704,42730,101434,38842,32180,71022
"547","1610201","0545320725","www.musees-cognac.fr","NOUVELLE-AQUITAINE","CHARENTE",65523448,"Musée Municipal de Cognac","48","Boulevard Denfert-Rochereau","16100","Cognac","France","fr","open",45.69592615,-0.325574396253921,2841,3700,6541,2787,2663,5450,2945,2953,5898,2744,3804,6548,1661,4371,6032,1825,8786,10611
"548","3211901","0562097138","site du département : www.gers-gascogne.com ou site de la mairie","OCCITANIE","GERS",110292132,"Musée Archéologique",NA,"Rue Marpoy","32800","Eauze","France","fr","open",43.8609266,0.101423170697417,6823,2437,9260,5904,1879,7783,8143,2051,10194,7358,2212,9570,7138,2112,9250,4319,1863,6182
"549","4209401","0477262448","www.feurs.org/culture/musee-d-archeologie.html","AUVERGNE-RHÔNE-ALPES","LOIRE",346317680,"Musée d'Archéologie",NA,"Rue Victor de Laprade","42110","Feurs","France","fr","open",45.7442509,4.2195524,1979,3464,5443,1622,2873,4495,2168,3292,5460,2185,4180,6365,2591,3711,6302,1133,4041,5174
"550","6330002","0473381853","www.riom-communaute.fr","AUVERGNE-RHÔNE-ALPES","PUY DE DÔME",700609622,"Musée Francisque Mandet","14","Rue de l'Hôtel de Ville","63200","Riom","France","fr","open",45.8935237,3.11663790664864,3203,12805,16008,11780,2671,14451,4687,11292,15979,3324,10462,13786,4482,9453,13935,3408,14176,17584
"551","2123106","0380488090","www.musees-bourgogne.org","BOURGOGNE-FRANCHE-COMTE","CÔTE D’OR",23363257,"Musée de la Vie Bourguignonne, Perrin de Puycousin",NA,"Rue du Chaignot","21000","Dijon","France","fr","open",47.31745415,5.03802576290512,0,36161,36161,0,36637,36637,0,40741,40741,0,33502,33502,0,33358,33358,0,42904,42904
"552","6816401","0389782136","www.musee-du-vignoble-alsace.fr","GRAND EST","HAUT-RHIN",55263399,"Musée du Vignoble et des Vins d'Alsace","1b","Grand'Rue","68240","Colmar-Ribeauvillé","France","fr","open",48.13509195,7.28839424431867,2880,0,2880,2645,20,2665,2586,45,2631,2911,40,2951,3267,0,3267,3241,0,3241
"553","7511504","0142792336","www.ladressemuseedelaposte.fr ou www.museedelaposte.fr","ÎLE-DE-France","PARIS",993828548,"L'Adresse Musée de la Poste",NA,"Boulevard de Vaugirard","75015","Paris","France","fr","open",48.8414574,2.3172246,11745,0,11745,0,30084,30084,12745,27182,39927,7389,1740,9129,0,20530,20530,71086,92017,163103
"554","7647401","0235743535","www.corderievallois.fr","NORMANDIE","SEINE-MARITIME",121934820,"Musée Industriel de la Corderie Vallois","185","Route de Dieppe","76960","Notre-Dame-de-Bondeville","France","fr","open",49.4951715,1.04791902173913,0,11329,11329,2562,7213,9775,2841,8525,11366,2502,7461,9963,2184,6823,9007,2321,7558,9879
"555","8619404","0549412124","www.musees-poitiers.org ou www.alienor.org","NOUVELLE-AQUITAINE","VIENNE",40140547,"Musée du baptistère Saint-Jean",NA,"Rue Paschal le Coq","86000","Poitiers","France","fr","open",46.57912245,0.347754414714965,10539,1918,12457,10626,1331,11957,11974,1462,13436,11414,1164,12578,11137,1124,12261,11656,1054,12710
"556","4410901","0240992620","http://museum.nantes.fr","PAYS DE LA LOIRE","LOIRE-ATLANTIQUE",6742735,"Muséum d'Histoire Naturelle de Nantes","12","Rue Voltaire","44000","Nantes","France","fr","open",47.2125868,-1.56470286492504,47681,96819,144500,38000,80000,118000,44237,94863,139100,36300,72200,108500,26000,69420,95420,23070,58485,81555
"557","3711301","0247949020","www.prehistoiregrandpressigny.fr","CENTRE-VAL DE LOIRE","INDRE ET LOIRE",2188754054,"Musée de Préhistoire du Grand Pressigny",NA,"Rue des Remparts","37350","Le Grand-Pressigny","France","fr","open",46.9218966,0.8034128,13212,3262,16474,12940,3074,16014,8143,7649,15792,9453,6667,16120,9742,6561,16303,8992,9131,18123
"558","4101804","0254552626","www.maisondelamagie.fr","CENTRE-VAL DE LOIRE","LOIR ET CHER",118645362,"Maison de la Magie",NA,"Grands Degrés du Château","41000","Blois","France","fr","open",47.5864248,1.33313364537456,75288,23325,98613,74266,23941,98207,70470,22615,93085,72621,24621,97242,68895,20693,89588,69711,22246,91957
"559","6822403","0389332323","www.collection-schlumpf.com - http://www.citedelautomobile.com/","GRAND EST","HAUT-RHIN",449007880,"Musée National de l'Automobile - Collection Schlumpf",NA,"Autodrome du Musée de l'Automobile","68100","Mulhouse","France","fr","open",47.7612848,7.32797155119644,157271,24702,181973,147583,27296,174879,161617,27383,189000,162727,26891,189618,159826,31117,190943,163224,27996,191220
"560","6241301","0321490229","Site de la ville : www.ville-harnes.fr/Patrimoine","HAUTS-DE-France","PAS-DE-CALAIS",110215831,"Musée d'Histoire et d'Archéologie",NA,"Rue du Musée","62440","Harnes","France","fr","open",50.447528,2.9107465,0,345,345,0,1123,1123,0,824,824,0,2315,2315,0,2128,2128,0,2891,2891
"561","1741501","0546935239","www.ville-saintes.fr ou www.alienor.org","NOUVELLE-AQUITAINE","CHARENTE-MARITIME",2400379556,"Musée de l'Echevinage",NA,"Place de l'Échevinage","17100","Saintes","France","fr","open",45.7459257,-0.6333715,1295,3364,4659,1507,3120,4627,859,2175,3034,2671,5265,7936,0,7015,7015,0,6774,6774
"562","1300405","0413315103","www.arles-antiques.cg13.fr","PROVENCE-ALPES-CÔTE D'AZUR","BOUCHES DU RHONE",5944281,"Musée Départemental de l'Arles Antique",NA,"Avenue Jean Monnet","13200","Arles","France","fr","open",43.6727255,4.61651483181682,29828,94462,124290,47832,94933,142765,49381,113103,162484,43003,108896,151899,59990,97275,157265,97975,116642,214617
"563","1301103","0490544599",NA,"PROVENCE-ALPES-CÔTE D'AZUR","BOUCHES DU RHONE",446697908,"Musée d'Histoire et d'Archéologie des Baux-de-Provence",NA,"Place Louis Jou","13520","Les Baux-de-Provence","France","fr","open",43.74474145,4.79499140166667,0,1e+05,1e+05,270000,0,270000,286086,0,286086,270000,0,270000,283847,0,283847,240000,20000,260000
"564","3815101","0476225863","www.ville-echirolles.fr/sortir/geocharles/geocharles.html","AUVERGNE-RHÔNE-ALPES","ISERE",81099317,"Musée Géo-Charles",NA,"Rue Géo Charles","38130","Échirolles","France","fr","open",45.14927925,5.69950042139831,0,0,0,0,2569,2569,0,7345,7345,0,7725,7725,0,7148,7148,0,7892,7892
"565","6321101","0473956008","www.livradois.com/marsac/penitent/index.htm","AUVERGNE-RHÔNE-ALPES","PUY DE DÔME",798314887,"Musée des Pénitents Blancs",NA,"Place de l'Église","63940","Marsac-en-Livradois","France","fr","open",45.4787455,3.7287661,101,7,108,134,78,212,108,6,114,192,81,273,254,27,281,181,0,181
"566","7511606","0158515200","http://www.citechaillot.fr/fr/musee/","ÎLE-DE-France","PARIS",5918699678,"Musée des Monuments Français",NA,"Rue Joliot-Curie","91190","Le Moulon","France","fr","open",48.7094092,2.1666145,87399,100417,187816,52730,68284,121014,80096,74906,155002,150417,130446,280863,191456,170204,361660,197884,221522,419406
"567","9000901","0384565752","www.musees-des-techniques.org ou www.ville-beaucourt.fr","BOURGOGNE-FRANCHE-COMTE","TERRITOIRE DE BELFORT",203596883,"Musée Frédéric Japy",NA,"Rue des Aiges","25230","Vandoncourt","France","fr","open",47.4692975,6.90605967289238,916,804,1720,1231,941,2172,952,1618,2570,937,1301,2238,612,1317,1929,1053,788,1841
"568","8504601","0251058784","www.lachaizelevicomte.fr/fr/information/6403/musee-ornithologique-charles-payraudeau","PAYS DE LA LOIRE","VENDEE",3790252198,"Musée ornithologique Charles-Payraudeau",NA,"Rue des Noyers","85310","La Chaize-le-Vicomte","France","fr","open",46.6720342,-1.2970252,215,294,509,259,302,561,116,413,529,196,656,852,75,238,313,162,516,678
"569","7724301","0164303078","Site de la ville","ÎLE-DE-France","SEINE ET MARNE",113256131,"Musée Gatien Bonnet",NA,"Cour Pierre Herbin","77400","Lagny-sur-Marne","France","fr","open",48.879835,2.707439,0,5498,5498,0,6021,6021,0,5941,5941,0,4533,4533,0,3905,3905,409,4782,5191
"570","1209601","0565441991","www.musees.aveyron.fr","OCCITANIE","AVEYRON",152864630,"Musée des Mœurs et Coutumes, Musée du Rouergue",NA,"Place Pierre Frontin","12500","Espalion","France","fr","open",44.5211405,2.76063250854585,639,386,1025,547,548,1095,34,962,996,142,1972,2114,1877,503,2380,1510,454,1964
"571","0608303","0493358464","Site de la ville","PROVENCE-ALPES-CÔTE D'AZUR","ALPES-MARITIMES",137783866,"Musée de Préhistoire Régionale",NA,"Rue Lieutenant Bosano","06500","Menton","France","fr","open",43.777006,7.50339416035806,1974,7842,9816,1966,5468,7434,2495,8582,11077,711,10903,11614,0,12036,12036,0,13378,13378
"572","0608812","0493534053","www.musee-matisse-nice.org","PROVENCE-ALPES-CÔTE D'AZUR","ALPES-MARITIMES",139931873,"Musée Matisse",NA,"Avenue des Arènes de Cimiez","06108","Nice","France","fr","open",43.7194,7.27620850999712,85877,73195,159072,66164,53464,119628,63981,51741,115722,89442,42281,131723,0,173128,173128,50512,131957,182469
"573","2611301","0475224005","www.museededie.org","AUVERGNE-RHÔNE-ALPES","DRÔME",145189774,"Musée d'Histoire et d'Archéologie","2","Rue Noé","56000","Vannes","France","fr","open",47.6568685,-2.75798382246377,1011,5670,6681,812,4425,5237,579,4843,5422,634,4683,5317,821,2960,3781,976,1055,2031
"574","3711501","0247597919","www.ville-descartes.fr/pratique/f_pratique.htm","CENTRE-VAL DE LOIRE","INDRE ET LOIRE",65229447,"""""""Maison Musée"""" René Descartes""","29","Rue Descartes","37160","Descartes","France","fr","open",46.9726209,0.699935549359743,1136,573,1709,1267,665,1932,1339,779,2118,1316,545,1861,1458,805,2263,1524,526,2050
"575","7405601","0450532593","www.cc-valleedechamonixmontblanc.fr","AUVERGNE-RHÔNE-ALPES","HAUTE-SAVOIE",97313427,"Musée Alpin",NA,"Rue de la Tournette","74400","Chamonix-Mont-Blanc","France","fr","open",45.9240251,6.87125744978451,23920,11781,35701,27057,10742,37799,22485,13262,35747,25304,15656,40960,11572,6010,17582,11014,5983,16997
"576","1411802","0231304760","www.musee-de-normandie.fr","NORMANDIE","CALVADOS",155642549,"Musée de Normandie",NA,"Allée du Chat qui Veille","14000","Caen","France","fr","open",49.18563295,-0.36325911813357,18726,31886,50612,20155,37414,57569,18390,32375,50765,27360,40123,67483,19357,72772,92129,35234,119038,154272
"577","7510501","0153737800","www.musee-moyenage.fr","ÎLE-DE-France","PARIS",56640163,"Musée du Moyen Age-Thermes et Hôtel de Cluny","6","Place Paul Painlevé","75005","Paris","France","fr","open",48.85064945,2.34356430101852,76040,82647,158687,124765,120149,244914,110960,119228,230188,136988,139939,276927,151987,165370,317357,148232,152258,300490
"578","2628101","0475055181","www.ville-romans.com","AUVERGNE-RHÔNE-ALPES","DRÔME",61078917,"Musée International de la Chaussure",NA,"Rue Saint-Just","26100","Romans-sur-Isère","France","fr","open",45.04446045,5.05424826197035,13228,9734,22962,11142,14294,25436,15977,13073,29050,17111,10861,27972,19981,11437,31418,19341,10549,29890
"579","9550001","0130380240","Site de la ville - www.ville-Pontoise.fr","ÎLE-DE-France","VAL D'OISE",43971811,"Musée Tavet Delacour",NA,"Rue Lemercier","95300","Pontoise","France","fr","open",49.0511035,2.09965863652879,1025,3403,4428,2876,2482,5358,3136,3669,6805,2337,3211,5548,4991,8457,13448,2841,3495,6336
"580","8106501","0563715930","www.ville-castres.fr","OCCITANIE","TARN",1436215239,"Musée Goya","1","Rue de l'Hôtel de Ville","81100","Castres","France","fr","open",43.6035253,2.2417743,18729,6259,24988,20216,5897,26113,12213,10435,22648,12164,11056,23220,21489,20473,41962,10651,15248,25899
"581","3155504","0561222182","www.augustins.org","OCCITANIE","HAUTE-GARONNE",22718219,"Musée des Augustins",NA,"Rue Antonin Mercié","31000","Toulouse","France","fr","open",43.6009417,1.44634333201202,49368,87764,137132,92923,73663,166586,57020,103149,160169,48755,80318,129073,76180,68574,144754,47259,74857,122116
"582","3726102","0247056873","www.mba.tours.fr ou www.musees-regioncentre.fr","CENTRE-VAL DE LOIRE","INDRE ET LOIRE",73677174,"Musée des Beaux-Arts",NA,"Rue Fleury","37000","Tours","France","fr","open",47.39526145,0.695059187452954,16471,46145,62616,17530,46221,63751,23319,45435,68754,21802,42102,63904,21575,40742,62317,17547,36723,54270
"583","1038703","0325730585","www.musees-troyes.com","GRAND EST","AUBE",73124719,"Musée Vauluisant - Musée de la Bonneterie",NA,"Rue de la Crosse","10000","Troyes","France","fr","open",48.29995,4.08229134200517,4403,8016,12419,2251,6133,8384,2890,5296,8186,2804,4374,7178,2113,4590,6703,1948,2989,4937
"584","6015904","0344202604","www.musee-vivenel.fr","HAUTS-DE-France","OISE",105680987,"Musée Antoine Vivenel",NA,"Rue de la Baguette","60200","Compiègne","France","fr","open",49.41750445,2.82119986268443,901,13836,14737,1437,14063,15500,2079,12095,14174,1458,11793,13251,1233,14444,15677,1345,4005,5350
"585","9404601","0143967052","http://musee.vet-alfort.fr","ÎLE-DE-France","VAL DE MARNE",2751882654,"Musée Fragonard",NA,"Avenue du Général de Gaulle","94700","Maisons-Alfort","France","fr","open",48.8128139,2.4233528,4273,4630,8903,4556,2067,6623,4518,5232,9750,3097,5275,8372,3267,5055,8322,3314,4928,8242
"586","8106901","0563560611","http://musee-charles-portal.asso-web.com ou http://savieuxcordes.canalblog.com","OCCITANIE","TARN",5168791210,"Musée Charles Portal - Histoire et Patrimoine",NA,"Rue Saint-Michel","81170","Cordes-sur-Ciel","France","fr","open",44.0637595,1.9490171,690,366,1056,864,418,1282,688,425,1113,517,256,773,742,260,1002,888,367,1255
"587","3417209","0467660294","www.montpellier.fr/3803-manifestations-culturelles.htm","OCCITANIE","HERAULT",598184808,"Musée du Vieux Montpellier",NA,"Place Pétrarque","34062","Montpellier","France","fr","open",43.6106627,3.8785261,599,5110,5709,499,4597,5096,521,4571,5092,739,4892,5631,611,4788,5399,1203,3023,4226
"588","1320601","0491547775","www.mairie-marseille.fr/vivre/culture/musees/cantini.htm","PROVENCE-ALPES-CÔTE D'AZUR","BOUCHES DU RHONE",69139913,"Musée Cantini",NA,"Rue Grignan","13006","Marseille","France","fr","open",43.2922074,5.37820841371263,29431,32996,62427,18493,21710,40203,54189,18614,72803,9262,18459,27721,22178,21334,43512,40722,59412,100134
"589","7654002","0235076661","www.reseau-canope.fr/musee/","NORMANDIE","SEINE-MARITIME",64717877,"MUNAE - Musée National de l'Education","6","Rue de Bihorel","76000","Rouen","France","fr","open",49.44841715,1.10295659681713,9941,11780,21721,9604,10666,20270,3145,14050,17195,10744,6727,17471,230,4579,4809,3733,5562,9295
"590","2417204","0553064545","www.musee-prehistoire-eyzies.fr","NOUVELLE-AQUITAINE","DORDOGNE",1708799591,"Musée National de la Préhistoire",NA,"Rue du Musée","24620","Sarlat-la-Canéda","France","fr","open",44.9362525,1.0135749,36445,34867,71312,37087,29675,66762,38470,32313,70783,39750,33781,73531,41005,37852,78857,43630,35030,78660
"591","7152601","0385358324","www.musees-bourgogne.org","BOURGOGNE-FRANCHE-COMTE","SAONE ET LOIRE",1153618944,"Musée Départemental de Préhistoire de Solutré",NA,"Chemin de la Roche","71960","Solutré-Pouilly","France","fr","open",46.2976296,4.718872,14277,10482,24759,12135,8294,20429,15857,10572,26429,10133,12094,22227,12814,8059,20873,15548,12771,28319
"592","8938701","0386838890","Site des musées de Bourgogne","BOURGOGNE-FRANCHE-COMTE","YONNE",8196077887,"Musée Muncipal","135","Rue des Déportés et de la Résistance","89100","Sens","France","fr","open",48.1975028,3.284393,6267,25109,31376,6474,19042,25516,7328,16229,23557,6427,14297,20724,6066,25735,31801,4063,24297,28360
"593","2546201","0381388214","www.ville-pontarlier.fr/vie-culturelle/musee/evenements.php","BOURGOGNE-FRANCHE-COMTE","DOUBS",34418085,"Musée de Pontarlier","2",NA,"25300","Pontarlier","France","fr","open",46.9043368,6.35475211267442,731,7244,7975,660,6593,7253,801,6179,6980,723,5858,6581,659,6340,6999,1170,6350,7520
"594","2123104","0380745209","http://mba.dijon.fr ou www.ville-dijon.fr","BOURGOGNE-FRANCHE-COMTE","CÔTE D’OR",175641505,"Musée des Beaux-Arts",NA,"Place de la Libération","21000","Dijon","France","fr","open",47.32163075,5.04236436172252,0,152331,152331,0,154164,154164,0,155692,155692,0,163381,163381,0,193733,193733,4859,166378,171237
"595","5745601","0387969151","http://www.musee-verre.webmuseo.com/","GRAND EST","MOSELLE",228213586,"Maison du Verre et du Cristal",NA,"Place Robert Schuman","57960","Meisenthal","France","fr","open",48.9650715,7.3526402258805,14225,3209,17434,15270,3623,18893,15560,3630,19190,16725,3133,19858,15131,2959,18090,17283,2368,19651
"596","6311301","0473426970","www.clermontmetropole.eu/-Musee-Bargoin-.html","AUVERGNE-RHÔNE-ALPES","PUY DE DÔME",67015490,"Musée d'Archéologie Bargoin",NA,"Place Louis Deteix","63100","Clermont-Ferrand","France","fr","open",45.79392705,3.11622231467696,3096,19947,23043,3857,21238,25095,4741,13295,18036,3601,11705,15306,6746,23368,30114,4304,12172,16476
"597","6827702","0389479215","www.musee-riquewihr.fr/","GRAND EST","HAUT-RHIN",1138681,"Musée du Dolder","16","Rue du Général de Gaulle","68340","Riquewihr","France","fr","open",48.166885,7.29856043408909,4203,1169,5372,2703,728,3431,1821,524,2345,1657,391,2048,1622,460,2082,1666,467,2133
"598","6834301","0389744474","www.ecomusee.alsace","GRAND EST","HAUT-RHIN",261857352,"Ecomusée d'Alsace",NA,"Chemin des Remparts","68190","Ungersheim","France","fr","open",47.85306625,7.28713333543546,155543,15548,171091,160522,23226,183748,176974,17391,194365,201929,0,201929,138857,57412,196269,158563,21390,179953
"599","3818507","0476544414","Site du patrimoine de l'Isère - www.patrimoine-en-isere.fr","AUVERGNE-RHÔNE-ALPES","ISERE",2388638743,"Musée Stendhal","20","Grande Rue","38000","Grenoble","France","fr","open",45.1915799,5.7281471,451,4112,4563,557,4085,4642,854,972,1826,1750,775,2525,2480,1489,3969,3857,1946,5803
"600","0272201","0323933050","http://www.musee-soissons.org","HAUTS-DE-France","AISNE",2306316571,"Musée Municipal de Soissons",NA,"Rue Démoustier","02600","Villers-Cotterêts","France","fr","open",49.2530103,3.0896156,7447,8000,15447,4000,7497,11497,4927,3866,8793,4114,9698,13812,0,31482,31482,0,25592,25592
"601","1433302","0231895400","www.musees-honfleur.fr - www.ville-honfleur.fr","NORMANDIE","CALVADOS",4377367191,"Musée Eugène Boudin",NA,"Rue de l'Homme de Bois","14600","Honfleur","France","fr","open",49.4223549,0.2305791,31330,5482,36812,29103,6362,35465,27342,3561,30903,19172,2856,22028,34354,2244,36598,42682,2623,45305
"602","2768101","0232212809","site de la ville www.ville-vernon27.fr/musee/","NORMANDIE","EURE",1612275797,"Musée Alphonse-Georges Poulain",NA,"Rue du Pont","27200","Vernon","France","fr","open",49.094892,1.4850183,9132,8516,17648,11359,6751,18110,10301,14274,24575,3527,10677,14204,3229,7994,11223,4216,10033,14249
"603","1730003","0546416465","www.alienor.org","NOUVELLE-AQUITAINE","CHARENTE-MARITIME",1445028137,"Musée des Beaux-Arts",NA,"Rue Gargoulleau","17000","La Rochelle","France","fr","open",46.1621097,-1.1515809,4511,11007,15518,5534,10753,16287,4212,11963,16175,3945,13707,17652,3747,12490,16237,4075,10501,14576
"604","8109902","0563573631","Site de la ville :  www.ville-gaillac.fr","OCCITANIE","TARN",60929966,"Muséum d'histoire naturelle Philadelphe Thomas",NA,"Rue Philadelphe Thomas","81600","Gaillac","France","fr","open",43.8993239,1.8943379,1098,2314,3412,1058,3734,4792,968,3756,4724,1195,5680,6875,1076,3816,4892,1383,3275,4658
"605","5815101","0386509108","www.sud-nivernais.fr","BOURGOGNE-FRANCHE-COMTE","NIÈVRE",228160124,"Musée de la Mine",NA,"Rue Paul et Auguste Couture","58260","La Machine","France","fr","open",46.88884495,3.46381676951912,5923,885,6808,5902,734,6636,5491,798,6289,5332,892,6224,6229,1081,7310,6503,1226,7729
"606","6806602","0389238415","www.museumcolmar.org","GRAND EST","HAUT-RHIN",47577843,"Musée d'Histoire Naturelle et d'Ethnographie de Colmar",NA,"Cour","68000","Colmar","France","fr","open",48.07362435,7.35882193815086,9836,5028,14864,10097,6754,16851,7789,5110,12899,7918,6367,14285,10000,8867,18867,8747,7155,15902
"607","1300102","0442214355","www.mairie-aixenprovence.fr/Musee-du-Vieil-Aix","PROVENCE-ALPES-CÔTE D'AZUR","BOUCHES DU RHONE",88614075,"Musée du Parlement de Provence et du Vieil Aix",NA,"Rue des Bremondis","13626","Aix-en-Provence","France","fr","open",43.53075485,5.44723930755179,4734,8653,13387,7615,9065,16680,0,24655,24655,0,13698,13698,0,29689,29689,0,33130,33130
"608","6900601","0474890890","www.graha-museethimonnier.org - http://musees.ouestrhodanien.fr/musee-barthelemy-thimonnier.html (nveau site) site de la ville","AUVERGNE-RHÔNE-ALPES","RHÔNE",312877023,"Musée Barthélemy-Thimonnier",NA,"Rue du Nord","69550","Amplepuis","France","fr","open",45.9729166,4.3306812,1604,1679,3283,2096,1667,3763,2012,2048,4060,1565,3191,4756,1535,3116,4651,3853,3416,7269
"609","7306501","0479337503","www.chambery.fr/206-musee-des-beaux-arts.htm","AUVERGNE-RHÔNE-ALPES","SAVOIE",107343549,"Musée des Beaux-Arts",NA,"Passage Jules Daisay","73000","Chambéry","France","fr","open",45.56817235,5.91971294241191,6171,22462,28633,6092,21874,27966,3851,16551,20402,5759,16481,22240,4881,21869,26750,12464,12907,25371
"610","5763001","0387080868","www.ville-sarrebourg.fr/Culture/Musee","GRAND EST","MOSELLE",2351192125,"Musée du Pays de Sarrebourg",NA,"Rue de la Paix","57400","Sarrebourg","France","fr","open",48.7352213,7.05534,8233,8391,16624,8878,7803,16681,8576,8066,16642,9163,7448,16611,9026,6986,16012,8690,9743,18433
"611","6718001","0388937922","http://www.ville-haguenau.fr/musee-historique","GRAND EST","BAS-RHIN",48609011,"Musée Historique",NA,"Rue du Sel","67500","Haguenau","France","fr","open",48.81306145,7.79150752275351,4586,754,5340,23,5574,5597,1331,3587,4918,2475,4730,7205,3353,12000,15353,2943,18272,21215
"612","8000101","0322240849","Site de la ville","HAUTS-DE-France","SOMME",638296084,"Musée Boucher-de-Perthes",NA,"Rue Gontier Patin","80100","Abbeville","France","fr","open",50.1071737,1.8333893,1730,8263,9993,1495,8362,9857,1578,10436,12014,9219,0,9219,8589,0,8589,6583,0,6583
"613","7510307","0144595858","www.carnavalet.paris.fr","ÎLE-DE-France","PARIS",2405955,"Musée Carnavalet-Histoire de Paris",NA,"Rue Payenne","75003","Paris","France","fr","open",48.85732325,2.36247337831078,0,8800,8800,0,8187,8187,8388,187404,195792,83205,236460,319665,77550,360234,437784,33724,395028,428752
"614","3155501","0562485800","www.lesabattoirs.org","OCCITANIE","HAUTE-GARONNE",22718219,"Les Abattoirs, Musée d'Art Moderne et Contemporain",NA,"Rue Antonin Mercié","31000","Toulouse","France","fr","open",43.6009417,1.44634333201202,42042,123828,165870,50048,109031,159079,52452,102641,155093,58508,95551,154059,32325,80118,112443,42703,77033,119736
"615","3724801","0247959118","www.musee-rabelais.fr ou site du conseil général","CENTRE-VAL DE LOIRE","INDRE ET LOIRE",1935506460,"Musée François Rabelais",NA,"Rue de La Devinière","37500","Seuilly","France","fr","open",47.1405133,0.1784807,10110,2665,12775,10058,2824,12882,9788,2032,11820,8963,2836,11799,9854,2523,12377,8913,3594,12507
"616","5502901","0329761467","site de la ville - http://www.barleduc.fr","GRAND EST","MEUSE",1491444871,"Musée Barrois",NA,NA,"55000","Bar-le-Duc","France","fr","open",48.7717157,5.1560282,3105,7592,10697,2858,6112,8970,2362,8032,10394,2301,7741,10042,2093,8701,10794,2250,7942,10192
"617","8614001","0549833980","www.lasabline.fr ou www.lussac-les-chateaux.fr","NOUVELLE-AQUITAINE","VIENNE",4717431552,"Musée de Préhistoire Raymond Touchard",NA,"Route de Montmorillon","86320","Lussac-les-Châteaux","France","fr","open",46.4036633,0.7257293,2114,3836,5950,3418,3562,6980,2600,4063,6663,2520,4241,6761,3243,4373,7616,1790,2883,4673
"618","7920201","0549645373","www.alienor.org ou www.cc-parthenay.fr/Patrimoine/Musee/presentation/present-2.htm","NOUVELLE-AQUITAINE","DEUX-SEVRES",7281748506,"Musée d'Art et d'Histoire Georges Turpin","1","Rue de la Vau Saint-Jacques","79200","Parthenay","France","fr","open",46.6519796,-0.2493419,0,7250,7250,0,6770,6770,0,6533,6533,0,9169,9169,0,8622,8622,0,8849,8849
"619","5918303","0328633339","www.museeportuaire.fr","HAUTS-DE-France","NORD",76418840,"Musée Portuaire",NA,"Rue du Gouvernement","59140","Dunkerque","France","fr","open",51.03788695,2.37179183532894,30153,31744,61897,48462,30386,78848,31712,23283,54995,32147,22864,55011,29857,24081,53938,28590,32399,60989
"620","0916001","0561038919","www.paysdolmes.org - www.geocities.com/amtpc2000","OCCITANIE","ARIEGE",7228420483,"Musée du Textile et du Peigne en Corne","65","Rue Jean Canal","09300","Lavelanet","France","fr","open",42.9296646,1.8454676,1743,711,2454,1755,503,2258,1934,386,2320,2643,0,2643,1810,531,2341,1396,507,1903
"621","6416001","0559298392","www.arnaga.com","NOUVELLE-AQUITAINE","PYRÉNÉES ATLANTIQUES",209763123,"Musée Edmond Rostand",NA,"Avenue du Docteur Alexandre Camino","64250","Larressore","France","fr","open",43.36763065,-1.42266645024568,76903,9698,86601,81407,7292,88699,82356,9417,91773,81356,10059,91415,62931,11178,74109,72065,11321,83386
"622","6330003","0473381731","www.riom-communaute.fr","AUVERGNE-RHÔNE-ALPES","PUY DE DÔME",700609623,"Musée Régional d'Auvergne",NA,"Rue Delille","63200","Riom","France","fr","open",45.8949948,3.11610067069705,0,2276,2276,0,3094,3094,0,2610,2610,369,2098,2467,261,1069,1330,357,1227,1584
"623","8902403","0386180550","Site des musées de Bourgogne","BOURGOGNE-FRANCHE-COMTE","YONNE",1256497741,"Musée Leblanc-Duvernois",NA,"Rue Gaston Gallimard","89600","Saint-Florentin","France","fr","open",48.0013166,3.7283151,0,1508,1508,0,822,822,0,1141,1141,0,0,0,0,1049,1049,0,882,882
"624","2915101","0298880775","www.musee.ville.morlaix.fr","BRETAGNE","FINISTERE",2628944132,"Musée de Morlaix",NA,"Hameau des Rochers","29410","Le Cloître-Saint-Thégonnec","France","fr","open",48.4797924,-3.7964981,7757,3131,10888,13461,4588,18049,14283,12132,26415,12104,12912,25016,17784,8351,26135,8789,12266,21055
"625","4205202","0477602884","http://www.ville-charlieu.fr/avoir/musees/musee-de-la-soierie","AUVERGNE-RHÔNE-ALPES","LOIRE",2959298116,"Musée de la Soierie",NA,"Rue Jean Morel","42190","Charlieu","France","fr","open",46.159575,4.1712806,4949,2286,7235,3326,1435,4761,4287,1256,5543,4359,1397,5756,4172,1621,5793,5440,1888,7328
"626","7422501","0450646418","http://www.mairie-rumilly74.fr/culture_patrimoine/notre_histoire_musee_de_rumilly","AUVERGNE-RHÔNE-ALPES","HAUTE-SAVOIE",7056652026,"Notre histoire, Musée de Rumilly",NA,"Place de la Manufacture","74150","Rumilly","France","fr","open",45.8619761,5.9480724,1548,662,2210,2400,1070,3470,3071,1089,4160,1346,1178,2524,1130,920,2050,2197,0,2197
"627","1927202","0555262215","Site de la ville","NOUVELLE-AQUITAINE","CORREZE",7280134059,"Musée de la Mémoire et des Industries Tullistes","1","Rue du 9 Juin 1944","19000","Tulle","France","fr","open",45.2602143,1.7513822,0,2353,2353,0,3707,3707,0,3307,3307,0,3277,3277,0,4140,4140,0,3787,3787
"628","3000701","0466869869","site de la ville - www.ville-ales.fr","OCCITANIE","GARD",5160411791,"Musée-Bibliothèque Pierre-André Benoît",NA,"Montée des Lauriers","30100","Alès","France","fr","open",44.1305571,4.0691724,3138,9569,12707,1615,10730,12345,3600,9087,12687,9904,9001,18905,2239,11110,13349,5572,17054,22626
"629","8400301","0490749530","Site OT de la ville","PROVENCE-ALPES-CÔTE D'AZUR","VAUCLUSE",1933370178,"Musée d'Apt",NA,"Place du Postel","84400","Apt","France","fr","open",43.8757289,5.3979308,2834,4751,7585,3003,5520,8523,2502,6371,8873,2386,6943,9329,2762,6523,9285,2666,5688,8354
"630","6926401","0474683370","www.musee-paul-dini.com","AUVERGNE-RHÔNE-ALPES","RHÔNE",2649845820,"Musée Paul Dini",NA,"Rue Grenette","69400","Villefranche-sur-Saône","France","fr","open",45.9908656,4.7211731,13983,8446,22429,5794,16753,22547,6541,15157,21698,4850,15486,20336,5020,18777,23797,7413,14771,22184
"631","5609001","0297369821","www.inzinzac-lochrist.fr/Ecomusee-des-Forges.6681.0.html","BRETAGNE","MORBIHAN",243636775,"Ecomusée Industriel des Forges",NA,"Rue des Mimosas","56650","Inzinzac-Lochrist","France","fr","open",47.8231743,-3.25552539999999,1673,1935,3608,1420,1794,3214,1606,1995,3601,1555,1761,3316,1520,1599,3119,1605,1593,3198
"632","0281001","0323962330","Site de la mairie - www.mairie-villerscotterets.fr","HAUTS-DE-France","AISNE",2306316571,"Musée Alexandre Dumas",NA,"Rue Démoustier","02600","Villers-Cotterêts","France","fr","open",49.2530103,3.0896156,917,994,1911,743,826,1569,675,758,1433,730,1031,1761,669,984,1653,744,1199,1943
"633","6061202","0344248672","www.musees-senlis.fr","HAUTS-DE-France","OISE",142255492,"Musée d'Art et d'Archéologie",NA,"Place Notre-Dame","60300","Senlis","France","fr","open",49.2064225,2.58662850062884,3679,7287,10966,3830,9006,12836,4375,8648,13023,4813,9945,14758,6694,11462,18156,5825,11339,17164
"634","9520501","0134383850","www.musee-renaissance.fr ou www.musee-château-ecouen.fr","ÎLE-DE-France","VAL D'OISE",355298205,"Musée de la Renaissance - Château d'Ecouen",NA,"Rue Paul Lorillon","95440","Écouen","France","fr","open",49.01583335,2.3756373812644,14577,40713,55290,15365,42479,57844,17471,42517,59988,16438,40158,56596,16243,39843,56086,15727,41274,57001
"635","7728401","0164348445","www.musee-bossuet.fr","ÎLE-DE-France","SEINE ET MARNE",112061664,"Musée Bossuet","5","Place Charles De Gaulle","77100","Meaux","France","fr","open",48.960741,2.87849143644068,3526,8634,12160,3669,6924,10593,3685,8599,12284,3252,8143,11395,7990,2832,10822,5028,4518,9546
"636","3813001","0474202488","www.musee-hector-berlioz.fr","AUVERGNE-RHÔNE-ALPES","ISERE",615739719,"Musée Hector Berlioz","69","Rue de la République","38260","La Côte-Saint-André","France","fr","open",45.3933564,5.2612214,0,15158,15158,0,14174,14174,0,12694,12694,0,14827,14827,0,15020,15020,0,13099,13099
"637","8902401","0386729640","Site des musées de Bourgogne","BOURGOGNE-FRANCHE-COMTE","YONNE",62627118,"Muséum - Maison de l'Eau",NA,"Rue Jeanne d'Arc","89000","Auxerre","France","fr","open",47.7970869,3.56181506240425,0,17994,17994,0,15324,15324,0,14605,14605,0,13787,13787,0,16659,16659,0,17259,17259
"638","7154301","0385512350","Site des musées de Bourgogne","BOURGOGNE-FRANCHE-COMTE","SAONE ET LOIRE",7419064527,"Hôtel Dieu - Musée Greuze",NA,"Rue de l'Hôpital","71700","Tournus","France","fr","open",46.5619544,4.9109248,4848,2119,6967,7004,1941,8945,7019,1735,8754,7331,2549,9880,8384,1639,10023,8534,2036,10570
"639","5602301","0297576600","www.ecomusee-st-degan.fr","BRETAGNE","MORBIHAN",449218730,"Ecomusée de Saint-Dégan",NA,"Rue Park Segal","56400","Brech","France","fr","open",47.7090601,-2.9935749,8548,2740,11288,8028,2035,10063,7690,2096,9786,8339,2362,10701,7431,1962,9393,7653,2801,10454
"640","6748205","0388525000","www.musees-strasbourg.eu","GRAND EST","BAS-RHIN",222359,"Cabinet des Estampes et des Dessins",NA,"Passage Hans Haug","67065","Strasbourg","France","fr","open",48.58102195,7.75084165866106,0,164,164,0,10500,10500,0,217,217,0,345,345,0,543,543,2666,4112,6778
"641","5917801","0327713880","www.museedelachartreuse.fr","HAUTS-DE-France","NORD",83720907,"Musée de la Chartreuse",NA,"Rue des Chartreux","59500","Douai","France","fr","open",50.3746382,3.07594007234735,4195,22383,26578,4236,17885,22121,2203,30451,32654,5821,32107,37928,7169,33903,41072,15163,41768,56931
"642","1305504","0491553600","Site de la ville","PROVENCE-ALPES-CÔTE D'AZUR","BOUCHES DU RHONE",178808268,"Musée des Docks Romains",NA,"Place Vivaux","13002","Marseille","France","fr","open",43.29679,5.36804887190227,0,13870,13870,0,13771,13771,0,18413,18413,0,15571,15571,39,12217,12256,0,9420,9420
"643","2123101","0380745270","http://mba.dijon.fr ou www.ville-dijon.fr","BOURGOGNE-FRANCHE-COMTE","CÔTE D’OR",2482864557,"Musée François Rude",NA,"Rue Vaillant","21000","Dijon","France","fr","open",47.321005,5.0442148,0,88968,88968,0,85291,85291,0,82965,82965,0,64708,64708,0,60071,60071,0,53752,53752
"644","2123107","0380488090","Site des musées de Bourgogne","BOURGOGNE-FRANCHE-COMTE","CÔTE D’OR",5141876795,"Musée d'Art Sacré",NA,"Rue Sainte-Anne","21000","Dijon","France","fr","open",47.3177794,5.0379087,0,12018,12018,0,8549,8549,0,8323,8323,0,6911,6911,0,7082,7082,0,11383,11383
"645","2813401","0237501861","www.musees.regioncentre.fr - site de la région","CENTRE-VAL DE LOIRE","EURE ET LOIR",182675003,"Musée d'Art et d'Histoire de Dreux",NA,"Place du Musée","28100","Dreux","France","fr","open",48.733925,1.36804117944785,993,10467,11460,765,10520,11285,1081,8971,10052,6468,0,6468,1657,5961,7618,1537,6272,7809
"646","2619801","0475006230","http://www.chateaux-ladrome.fr/fr/chateau-des-adhemar-montelimar","AUVERGNE-RHÔNE-ALPES","DRÔME",3847795321,"Musée du Château des Adhémars",NA,"Place Saint-Martin","26200","Montélimar","France","fr","open",44.5622891,4.7528529,11491,11955,23446,11957,12613,24570,12277,8534,20811,10496,8074,18570,11445,7631,19076,17095,0,17095
"647","2A00403","0495262626","www.musee-fesch.com","CORSE","CORSE DU SUD",66274796,"Musée Palais Fesch","50-52","Rue Cardinal Fesch","20000","Ajaccio","France","fr","open",41.9218958,8.73891355528631,27554,20343,47897,21490,19797,41287,24716,18647,43363,21804,16483,38287,23667,16508,40175,23400,11984,35384
"648","0831101","0324265076","www.culture.gouv.fr/champagne-ardenne/2culture/musee_france/musee_mouzon.html","GRAND EST","ARDENNES",1879820958,"Musée du Feutre",NA,"Rue Du Colombier","08210","Mouzon","France","fr","open",49.6060032,5.0749863,2853,1156,4009,2659,1360,4019,3184,950,4134,2714,1159,3873,3614,974,4588,5196,2502,7698
"649","0230401","0323567191","http://perso.wanadoo.fr/lafere/musee.htm","HAUTS-DE-France","AISNE",4200402074,"Musée Jeanne d'Aboville",NA,"Rue du Général de Gaulle","02800","La Fère","France","fr","open",49.6618629,3.3677694,542,1067,1609,590,771,1361,342,1348,1690,361,1897,2258,322,1041,1363,218,623,841
"650","7511001",NA,"www.museedelapub.org et www.lesartsdecoratifs.fr/","ÎLE-DE-France","PARIS",56640163,"Musée de la Publicité (MAD)","6","Place Paul Painlevé","75005","Paris","France","fr","open",48.85064945,2.34356430101852,0,0,0,0,0,0,0,0,0,0,0,0,0,0,0,0,0,0
"651","7864601","0139503032","www.musee-lambinet.com","ÎLE-DE-France","YVELINES",1482437177,"Musée Lambinet",NA,"Boulevard de la Reine","78000","Versailles","France","fr","open",48.8087784,2.1305005,8649,7368,16017,9196,8475,17671,8449,6555,15004,6532,6462,12994,5241,5818,11059,10283,5030,15313
"652","1320201","0484351313","http://www.mucem.org","PROVENCE-ALPES-CÔTE D'AZUR","BOUCHES DU RHONE",168685674,"Musée des Civilisations de l'Europe et de la Méditerranée - MuCem","7","Promenade Robert Laffont","13002","Marseille","France","fr","open",43.29672875,5.36102547336816,306123,243787,549910,234883,214026,448909,342130,245929,588059,314183,224768,538951,416008,258043,674051,433949,158800,592749
"653","6015903","0344384700","http://palaisdecompiegne.fr/un-palais-trois-musees/le-musee-national-de-la-voiture-et-du-tourisme","HAUTS-DE-France","OISE",105680987,"Musée national de la Voiture et du Tourisme (Annexe du musée National du Château de Compiègne)",NA,"Rue de la Baguette","60200","Compiègne","France","fr","open",49.41750445,2.82119986268443,0,0,0,0,0,0,0,0,0,0,0,0,0,0,0,0,0,0
"654","7649701","0235681389","www.museepierrecorneille.fr","NORMANDIE","SEINE-MARITIME",69426369,"Musée Départemental Pierre Corneille","502","Rue Pierre Corneille","76650","Petit-Couronne","France","fr","open",49.38956865,1.02123617350963,0,2700,2700,0,3348,3348,247,2841,3088,565,3557,4122,705,3516,4221,725,3254,3979
"655","6827801","0389642456","www.museepapierpeint.org","GRAND EST","HAUT-RHIN",1936849476,"Musée du Papier Peint","28","Rue Zuber","68170","Rixheim","France","fr","open",47.7444268,7.3972851,6334,5928,12262,6287,5156,11443,5533,5190,10723,5571,5000,10571,7042,4816,11858,7148,4857,12005
"656","3720501","0247268650","www.musee-balzac.fr","CENTRE-VAL DE LOIRE","INDRE ET LOIRE",68962958,"Musée Balzac",NA,"Rue du Château","37190","Saché","France","fr","open",47.2457987,0.544644168793445,12578,6352,18930,12355,5090,17445,13673,5034,18707,12857,7419,20276,12639,7526,20165,25214,14160,39374
"657","5145407","0326353470",NA,"GRAND EST","MARNE",90739087,"Musée de l'Ancien Collège des Jésuites/Planétarium",NA,"Rue Pepersack","51100","Reims","France","fr","open",49.2501522,4.050214953701,23286,15524,38810,23257,17544,40801,24639,18563,43202,23062,17793,40855,24024,22838,46862,6842,12670,19512
"658","8512901","0251476161","www.historial.vendee.fr","PAYS DE LA LOIRE","VENDEE",113036200,"Historial de la Vendée",NA,"Allée Paul Bazin","85170","Les Lucs-sur-Boulogne","France","fr","open",46.845717,-1.48123488624133,22612,36378,58990,18952,37005,55957,19288,48421,67709,22477,32819,55296,34772,38461,73233,35596,23844,59440
"659","8519401","0251320116","www.lessablesdolonne.fr","PAYS DE LA LOIRE","VENDEE",1793366945,"Musée de l'Abbaye de Sainte-Croix",NA,"Rue de Verdun","85100","Les Sables-d'Olonne","France","fr","open",46.4969604,-1.7770051,6314,18172,24486,7377,16330,23707,3924,15434,19358,5556,18422,23978,4066,9701,13767,7064,15033,22097
"660","8212102","0563221291","www.ingres.com","OCCITANIE","TARN-ET-GARONNE",127805191,"Musée Ingres",NA,"Rue Marie Lafon","82000","Montauban","France","fr","open",44.01688865,1.3514607739558,0,13133,13133,0,18467,18467,18887,24480,43367,15450,21174,36624,15168,22491,37659,14651,23111,37762
"661","5235301","0325318921","www.villedenogent52.com","GRAND EST","HAUTE-MARNE",5915925232,"Musée de la Coutellerie",NA,"Place Charles de Gaulle","52800","Nogent","France","fr","open",48.0275986,5.3411994,3896,881,4777,4573,1734,6307,3920,1402,5322,4321,1458,5779,3188,1770,4958,4161,2088,6249
"662","6748204","0388525000","www.musees-strasbourg.eu","GRAND EST","BAS-RHIN",239825781,"Musée des Arts Décoratifs",NA,"Place du Marché aux Poissons","67065","Strasbourg","France","fr","open",48.5807532,7.7523558,38197,41400,79597,33981,36166,70147,28487,30098,58585,29875,31243,61118,25853,31526,57379,27328,26714,54042
"663","1038702","0325423333","www.musees-troyes.com","GRAND EST","AUBE",73124719,"Musée Vauluisant - Musée Historique de Troyes et de la Champagne",NA,"Rue de la Crosse","10000","Troyes","France","fr","open",48.29995,4.08229134200517,0,0,0,0,0,0,0,0,0,0,0,0,0,0,0,0,0,0
"664","1136901","0468468948","www.amphoralis.com","OCCITANIE","AUDE",758324962,"Musée Archéologique",NA,"Chemin de Halage","11590","Sallèles-d'Aude","France","fr","open",43.273517,2.93699631329114,7044,2160,9204,6858,5920,12778,6111,4761,10872,6004,4763,10767,6084,4469,10553,6494,1482,7976
"665","7718601","0160715070","www.châteaudefontainebleau.fr","ÎLE-DE-France","SEINE ET MARNE",214892,"Musée du Château de Fontainebleau",NA,"Cour du Cheval Blanc","77300","Fontainebleau","France","fr","open",48.4023346,2.70053873669076,201416,246891,448307,190437,270755,461192,185548,237317,422865,237927,222643,460570,257286,259625,516911,245658,208214,453872
"666","3002801","0466505056","Site dela ville ou Site du conseil général","OCCITANIE","GARD",3778245095,"Musée Albert André",NA,"Place Auguste Mallet","30200","Bagnols-sur-Cèze","France","fr","open",44.1619056,4.6203171,44,4530,4574,152,4335,4487,78,5072,5150,87,3979,4066,23,3992,4015,29,4805,4834
"667","1305508","0491145866","www.mairie-marseille.fr/vivre/culture/musees.htm","PROVENCE-ALPES-CÔTE D'AZUR","BOUCHES DU RHONE",68976388,"Musée d'Arts Africains, Océaniens, Amérindiens",NA,"Rue Édouard Stéphan","13004","Marseille","France","fr","open",43.30459645,5.39403959608706,0,0,0,0,0,0,0,0,0,0,0,0,0,0,0,0,0,0
"668","8305003","0494470572","www.culture-dracenie.com ou http://www.dracenie.com/","PROVENCE-ALPES-CÔTE D'AZUR","VAR",69759054,"Musée des A.T.P. de Moyenne Provence",NA,"Place du Docteur Calvini",NA,"Fréjus","France","fr","open",43.43331025,6.73648460170445,1713,9930,11643,1157,9147,10304,1937,8878,10815,1681,7660,9341,2284,6248,8532,2376,7603,9979
"669","3536003","0299750454","site de l'office du tourisme","BRETAGNE","ILE ET VILAINE",3203173830,"Musée des Rochers-Sévigné",NA,"Promenade du Val","35500","Vitré","France","fr","open",48.1254552,-1.2110814,2496,503,2999,0,0,0,3001,0,3001,0,0,0,4664,0,4664,5914,0,5914
"670","5618101","0297825672","www.musee-marine.fr/port-louis","BRETAGNE","MORBIHAN",2854735858,"Musée National de la Marine",NA,"Grand pont","56290","Port-Louis","France","fr","open",47.7102292,-3.3642103,39896,31547,71443,40427,29307,69734,37439,28890,66329,39756,30292,70048,37898,29049,66947,33877,26931,60808
"671","8002101","0322971400","www.amiens.fr/musees","HAUTS-DE-France","SOMME",140247228,"Musée de Picardie",NA,"Rue Jules Lardière","80000","Amiens","France","fr","open",49.890586,2.29521836657695,0,1776,1776,3207,7747,10954,6048,24808,30856,7415,30149,37564,6706,35819,42525,6015,29002,35017
"672","6015905","0344407255","www.musee-figurine.fr","HAUTS-DE-France","OISE",5339422294,"Musée de la Figurine Historique","1,3,5,7","Rue Jean Legendre","60200","Compiègne","France","fr","open",49.4176885,2.8264396,4431,3589,8020,2407,5766,8173,2586,5306,7892,2609,6605,9214,2930,6838,9768,4720,4254,8974
"673","9207301","0141183737","http://webmuseo.com/ws/musee-suresnes/app/report","ÎLE-DE-France","HAUTS DE SEINE",70961327,"MUS - Musée d'Histoire Urbaine et Sociale","1","Rue Merlin de Thionville","92150","Suresnes","France","fr","open",48.8682076,2.22161982385787,4589,6721,11310,5411,3835,9246,3850,4793,8643,1510,6495,8005,1059,5876,6935,554,5646,6200
"674","5226902","0325870805","http://www.musees-langres.fr","GRAND EST","HAUTE-MARNE",489598272,"Musée d'Art et d'Histoire",NA,"Rue de la Coutellerie","52200","Langres","France","fr","open",47.8646223,5.33333155724443,5415,6966,12381,2969,5403,8372,3666,5643,9309,2408,6949,9357,2775,4210,6985,4373,807,5180
"675","7510902","0145237409","www.museefm.org","ÎLE-DE-France","PARIS",1336873192,"Musée de la Franc-Maçonnerie","16","Rue Cadet","75009","Paris","France","fr","open",48.8749151,2.3431481,11392,7405,18797,12468,6993,19461,15950,6160,22110,10350,1610,11960,13963,3530,17493,11644,2683,14327
"676","9301301","0149927000","www.museeairespace.fr","ÎLE-DE-France","SEINE SAINT-DENIS",81191118,"Musée de l'Air et de l'Espace",NA,"Avenue Alain Bozel","93350","Dugny","France","fr","open",48.94707965,2.43507079706596,105561,88833,194394,115058,164875,279933,121826,70137,191963,126785,168627,295412,171725,96334,268059,136241,161544,297785
"677","1715301","0546013464","www.maison-baiemaraispoitevin.fr","NOUVELLE-AQUITAINE","CHARENTE-MARITIME",81375628,"Musée de la Mytiliculture",NA,"Rue de l'Église","17137","Esnandes","France","fr","open",46.2492163,-1.10993626696363,2543,566,3109,3304,863,4167,4497,577,5074,4787,303,5090,2352,306,2658,2681,305,2986
"678","7851702","0175034460","www.rambolitrain.fr","ÎLE-DE-France","YVELINES",130921984,"Musée Rambolitrain",NA,"Avenue du Maréchal Foch","78120","Rambouillet","France","fr","open",48.6460441,1.82417259800036,14566,2414,16980,2852,16377,19229,16327,2265,18592,13696,2150,15846,15094,3348,18442,15220,2736,17956
"679","7510106","0140205050","www.louvre.fr","ÎLE-DE-France","PARIS",7515426,"Musée du Louvre",NA,"Rue Croix des Petits Champs","75001","Paris","France","fr","open",48.8611473,2.33802768704666,5988065,4117897,10105962,5411926,2610343,8022269,4557028,2481376,7038404,5435535,2933898,8369433,5646956,3454918,9101874,5635387,3498880,9134267
"680","7510703","0144186110","www.musee-rodin.fr","ÎLE-DE-France","PARIS",472159547,"Musée National Auguste Rodin",NA,"Rue de Varenne","75007","Paris","France","fr","open",48.85474735,2.31586699986254,390870,169105,559975,396578,179858,576436,414142,169865,584007,389619,162405,552024,484125,203132,687257,442403,247479,689882
"681","9001001","0384542551","www.musees-franchecomte.com ou http://www.ville-belfort.fr/","BOURGOGNE-FRANCHE-COMTE","TERRITOIRE DE BELFORT",34588114,"Musée d'Art et d'Histoire",NA,"Allée de l'Option Française","90000","Belfort","France","fr","open",47.63662965,6.86473506813033,3227,13151,16378,4254,19598,23852,3952,18798,22750,18182,0,18182,24158,0,24158,19605,0,19605
"682","6737201","0388078005","http://webmuseo.com/ws/musee-image-populaire","GRAND EST","BAS-RHIN",158554855,"Musée de l'Image Populaire de Pfaffenhoffen",NA,"Rue du Docteur Albert Schweitzer","67350","Haguenau-Wissembourg","France","fr","open",48.84483,7.61157286364198,1172,862,2034,1274,922,2196,1124,1005,2129,1255,817,2072,1304,859,2163,1462,841,2303
"683","0606903","0497055811","www.museesdegrasse.fr","PROVENCE-ALPES-CÔTE D'AZUR","ALPES-MARITIMES",67332908,"Musée International de la Parfumerie",NA,"Boulevard du Jeu de Ballon","06130","Grasse","France","fr","open",43.65805315,6.92185503385852,77066,44362,121428,75236,45262,120498,69657,41079,110736,63209,40008,103217,61062,29248,90310,68250,23981,92231
"684","5554501","0329861062","www.musee-princerie.fr","GRAND EST","MEUSE",1369481,"Musée de la Princerie",NA,"Impasse de la Magdeleine","55100","Verdun","France","fr","open",49.161075,5.38263162502593,1496,4367,5863,1866,3761,5627,1845,3116,4961,1300,3191,4491,1873,2368,4241,1619,3732,5351
"685","5807901","0386271799","www.musees-bourgogne.org","BOURGOGNE-FRANCHE-COMTE","NIÈVRE",2627307760,"Musée d'Art et d'Histoire Romain Rolland",NA,"Avenue de la République","58500","Clamecy","France","fr","open",47.4603634,3.5204872,1934,1822,3756,1772,2018,3790,2095,2698,4793,2012,2687,4699,2451,2428,4879,2218,2048,4266
"686","5546701","0329907050","http://www.cg55.fr","GRAND EST","MEUSE",6051104311,"Musée Départemental Raymond Poincaré","14","Rue du Château","55300","Sampigny","France","fr","open",48.827556,5.5077794,0,3731,3731,0,4693,4693,0,3747,3747,0,4636,4636,0,5410,5410,0,2338,2338
"687","7753301","0164237327","www.musee-mallarme.fr","ÎLE-DE-France","SEINE ET MARNE",249312019,"Musée départemental Stéphane Mallarmé",NA,"Quai Stéphane Mallarmé","77870","Vulaines-sur-Seine","France","fr","open",48.43122295,2.74706992416045,861,2818,3679,1511,2564,4075,1387,1942,3329,1275,2981,4256,1655,2688,4343,3978,2131,6109
"688","5920501","0327321240","http//clec.free.fr","HAUTS-DE-France","NORD",1719221067,"Musée Municipal d'Escaudain",NA,"Rue Paul Bert","59124","Escaudain","France","fr","open",50.3330601,3.3443559,0,479,479,0,600,600,0,600,600,0,237,237,0,374,374,0,327,327
"689","7625501","0235864400","www.louis-philippe.eu - www.ville-eu.fr ou site des musées de la région","NORMANDIE","SEINE-MARITIME",972189944,"Musée Louis-Philippe du Château d'Eu",NA,"Allée du Cheval","76260","Eu","France","fr","open",50.0493649,1.4171188,14854,4173,19027,14114,3728,17842,12460,4349,16809,13422,5918,19340,14542,4309,18851,14086,4319,18405
"690","7654007","0235714150","http://museumderouen.fr/fr","NORMANDIE","SEINE-MARITIME",64180707,"Muséum d'Histoire Naturelle","198","Rue Beauvoisine","76000","Rouen","France","fr","open",49.44710085,1.09900360030984,3052,44666,47718,4855,44682,49537,15083,31795,46878,5186,31087,36273,5516,30871,36387,14740,13863,28603
"691","7675801","0235950840",NA,"NORMANDIE","SEINE-MARITIME",122011226,"Musée Municipal des Ivoires","8","Place du Maréchal Joffre","76190","Yvetot","France","fr","open",49.6173905,0.755111356884056,615,264,879,592,167,759,660,327,987,678,289,967,684,361,1045,362,898,1260
"692","3400302","0467946960","www.museecapdagde.com","OCCITANIE","HERAULT",1131132,"Musée de l'Ephèbe",NA,"Place du Père Marcel Astruc","34300","Agde","France","fr","open",43.2868906,3.51373204189873,8764,4831,13595,8607,5436,14043,8701,4483,13184,8982,4575,13557,9563,6473,16036,9060,6899,15959
"693","0318501","0470021962","www.mupop.fr","AUVERGNE-RHÔNE-ALPES","ALLIER",2511432939,"Musée des Musiques Populaires - MuPop",NA,"Rue Notre-Dame","03100","Montluçon","France","fr","open",46.3408843,2.6055312,17011,5663,22674,22887,300,23187,14907,710,15617,24225,805,25030,22582,2221,24803,9791,7387,17178
